Year,Player,Pos,Age,Tm,G,GS,MP,FG,FGA,FG%,3P,3PA,3P%,2P,2PA,2P%,eFG%,FT,FTA,FT%,ORB,DRB,TRB,AST,STL,BLK,TOV,PF,PTS
2000,Ray Allen*,SG,24,MIL,5,5,186,40,90,0.444,10,26,0.385,30,64,0.469,0.5,20,22,0.909,10,23,33,13,8,0,9,10,110
2000,Rafer Alston,PG,23,MIL,4,0,16,0,3,0,0,1,0,0,2,0,0,0,2,0,0,0,0,1,0,0,1,0,0
2000,Nick Anderson,SG,32,SAC,5,5,132,11,34,0.324,7,20,0.35,4,14,0.286,0.426,7,8,0.875,4,13,17,2,1,3,4,9,36
2000,Greg Anthony,PG,32,POR,15,0,213,19,52,0.365,10,31,0.323,9,21,0.429,0.462,12,16,0.75,2,14,16,25,13,4,12,27,60
2000,Stacey Augmon,SG,31,POR,7,0,34,4,12,0.333,0,0,0,4,12,0.333,0.333,1,2,0.5,0,2,2,0,0,0,0,6,9
2000,Toby Bailey,SG,24,PHO,5,0,15,1,4,0.25,0,0,0,1,4,0.25,0.25,2,4,0.5,1,1,2,2,0,0,0,1,4
2000,Vin Baker,C,28,SEA,5,4,177,30,75,0.4,0,1,0,30,74,0.405,0.4,10,17,0.588,16,22,38,10,5,2,16,19,70
2000,Brent Barry,SG,28,SEA,5,3,155,12,33,0.364,8,20,0.4,4,13,0.308,0.485,10,14,0.714,3,10,13,15,3,3,7,20,42
2000,Jon Barry,SG,30,SAC,5,0,102,9,21,0.429,7,12,0.583,2,9,0.222,0.595,14,16,0.875,2,10,12,12,3,0,4,7,39
2000,Jonathan Bender,SF,19,IND,9,0,21,4,6,0.667,1,1,1,3,5,0.6,0.75,3,6,0.5,0,3,3,0,1,0,0,2,12
2000,Travis Best,PG,27,IND,23,0,463,77,179,0.43,13,30,0.433,64,149,0.43,0.466,37,44,0.841,15,42,57,66,19,4,25,61,204
2000,Corie Blount,PF,31,PHO,9,0,162,17,31,0.548,0,0,0,17,31,0.548,0.548,10,18,0.556,25,31,56,3,6,6,13,36,44
2000,Muggsy Bogues,PG,35,TOR,3,2,87,6,21,0.286,3,9,0.333,3,12,0.25,0.357,1,3,0.333,3,3,6,5,4,0,4,4,16
2000,Lazaro Borrell,SF,27,SEA,2,1,26,4,7,0.571,0,0,0,4,7,0.571,0.571,2,4,0.5,3,8,11,1,0,0,1,2,10
2000,Bruce Bowen,SF,28,MIA,10,0,157,10,27,0.37,5,22,0.227,5,5,1,0.463,10,16,0.625,1,9,10,8,7,4,6,27,35
2000,Ira Bowman,SG,26,PHI,7,0,11,0,2,0,0,1,0,0,1,0,0,0,2,0,0,0,0,2,0,0,0,0,0
2000,Terrell Brandon,PG,29,MIN,4,4,162,32,63,0.508,4,11,0.364,28,52,0.538,0.54,10,11,0.909,4,19,23,34,3,0,8,11,78
2000,Dee Brown,PG,31,TOR,3,0,19,0,4,0,0,3,0,0,1,0,0,0,0,0,0,2,2,2,2,0,1,4,0
2000,P.J. Brown,PF,30,MIA,10,10,308,35,82,0.427,0,0,0,35,82,0.427,0.427,5,6,0.833,26,56,82,11,8,4,11,42,75
2000,Rick Brunson,PG,27,NYK,3,0,4,0,1,0,0,0,0,0,1,0,0,0,0,0,0,0,0,1,1,0,0,2,0
2000,Kobe Bryant,SG,21,LAL,22,22,857,174,394,0.442,22,64,0.344,152,330,0.461,0.47,95,126,0.754,26,72,98,97,32,32,55,89,465
2000,Jud Buechler,SF,31,DET,3,0,34,2,7,0.286,2,5,0.4,0,2,0,0.429,0,0,0,0,4,4,1,0,1,0,4,6
2000,Rodney Buford,SG,22,MIA,1,0,16,4,8,0.5,1,2,0.5,3,6,0.5,0.563,2,2,1,0,1,1,1,0,0,0,3,11
2000,Marcus Camby,C,25,NYK,16,0,386,29,86,0.337,0,1,0,29,85,0.341,0.337,19,31,0.613,35,77,112,6,8,23,12,51,77
2000,Elden Campbell,C,31,CHH,4,4,150,22,47,0.468,0,1,0,22,46,0.478,0.468,13,14,0.929,9,24,33,4,2,4,8,16,57
2000,Anthony Carter,PG,24,MIA,10,3,275,32,77,0.416,1,6,0.167,31,71,0.437,0.422,12,16,0.75,8,32,40,56,12,2,23,22,77
2000,Vince Carter,SF,23,TOR,3,3,119,15,50,0.3,1,10,0.1,14,40,0.35,0.31,27,31,0.871,9,9,18,19,3,4,8,12,58
2000,Sam Cassell,PG,30,MIL,5,5,178,30,72,0.417,1,5,0.2,29,67,0.433,0.424,18,21,0.857,0,17,17,45,4,0,9,19,79
2000,Chris Childs,PG,32,NYK,16,0,334,27,70,0.386,9,28,0.321,18,42,0.429,0.45,24,28,0.857,1,36,37,39,7,0,14,53,87
2000,Doug Christie,SG,29,TOR,3,1,61,3,13,0.231,3,8,0.375,0,5,0,0.346,3,6,0.5,1,4,5,6,4,1,4,10,12
2000,Derrick Coleman,PF,32,CHH,4,4,169,27,57,0.474,5,16,0.313,22,41,0.537,0.518,22,28,0.786,10,40,50,14,3,12,13,11,81
2000,Tyrone Corbin,SF,37,SAC,3,0,23,2,5,0.4,0,2,0,2,3,0.667,0.4,0,1,0,1,4,5,3,0,0,0,2,4
2000,Austin Croshere,PF,24,IND,23,2,490,64,153,0.418,15,37,0.405,49,116,0.422,0.467,73,87,0.839,31,78,109,19,9,16,25,51,216
2000,John Crotty,PG,30,DET,3,0,51,2,10,0.2,0,3,0,2,7,0.286,0.2,2,2,1,0,4,4,4,1,1,4,4,6
2000,Dell Curry,SG,35,TOR,3,0,30,2,4,0.5,2,3,0.667,0,1,0,0.75,1,2,0.5,1,1,2,1,2,0,2,4,7
2000,Michael Curry,SG,31,DET,3,1,79,12,23,0.522,0,0,0,12,23,0.522,0.522,4,6,0.667,0,3,3,3,1,1,2,5,28
2000,Antonio Daniels,SG,24,SAS,4,0,82,9,23,0.391,2,8,0.25,7,15,0.467,0.435,9,13,0.692,2,8,10,6,7,0,6,5,29
2000,Antonio Davis,C,31,TOR,3,3,105,14,24,0.583,0,0,0,14,24,0.583,0.583,11,14,0.786,7,18,25,3,1,4,4,9,39
2000,Baron Davis,PG,20,CHH,4,0,57,10,23,0.435,1,6,0.167,9,17,0.529,0.457,2,4,0.5,3,3,6,6,4,0,3,6,23
2000,Dale Davis,C,30,IND,23,23,714,79,151,0.523,0,0,0,79,151,0.523,0.523,32,59,0.542,83,180,263,17,11,31,18,83,190
2000,Todd Day,SG,30,PHO,9,0,100,16,35,0.457,5,16,0.313,11,19,0.579,0.529,5,10,0.5,6,4,10,4,4,1,4,24,42
2000,Vinny Del Negro,PG,33,MIL,5,0,93,13,30,0.433,0,2,0,13,28,0.464,0.433,0,0,0,0,8,8,9,3,0,3,4,26
2000,Tony Delk,PG,26,SAC,5,0,101,18,41,0.439,3,5,0.6,15,36,0.417,0.476,17,23,0.739,11,7,18,7,3,0,8,11,56
2000,Derrick Dial,SG,24,SAS,2,0,8,2,4,0.5,0,0,0,2,4,0.5,0.5,1,2,0.5,2,0,2,0,0,0,0,1,5
2000,Vlade Divac,C,31,SAC,5,5,160,20,56,0.357,0,2,0,20,54,0.37,0.357,16,23,0.696,9,27,36,14,7,4,9,22,56
2000,Chris Dudley,C,34,NYK,5,2,43,1,2,0.5,0,0,0,1,2,0.5,0.5,2,2,1,5,7,12,2,1,1,1,11,4
2000,Howard Eisley,PG,27,UTA,10,0,200,17,55,0.309,9,19,0.474,8,36,0.222,0.391,8,9,0.889,1,17,18,19,6,1,13,24,51
2000,Mario Elie,SF,36,SAS,4,4,115,6,22,0.273,1,7,0.143,5,15,0.333,0.295,17,18,0.944,5,12,17,7,5,0,12,4,30
2000,Sean Elliott,SF,31,SAS,4,4,119,15,40,0.375,5,13,0.385,10,27,0.37,0.438,5,8,0.625,1,21,22,5,0,2,4,13,40
2000,Patrick Ewing*,C,37,NYK,14,14,461,71,170,0.418,0,0,0,71,170,0.418,0.418,62,89,0.697,29,104,133,6,16,20,27,48,204
2000,Derek Fisher,PG,25,LAL,21,0,322,34,79,0.43,12,29,0.414,22,50,0.44,0.506,19,25,0.76,4,18,22,41,11,1,9,30,99
2000,Greg Foster,PF,31,SEA,5,0,68,7,19,0.368,2,5,0.4,5,14,0.357,0.421,2,2,1,1,10,11,1,0,1,3,14,18
2000,Rick Fox,SF,30,LAL,23,0,331,33,73,0.452,18,39,0.462,15,34,0.441,0.575,16,21,0.762,11,27,38,28,9,0,16,68,100
2000,Lawrence Funderburke,PF,29,SAC,4,0,34,4,9,0.444,0,0,0,4,9,0.444,0.444,2,4,0.5,4,7,11,0,1,0,0,0,10
2000,Kevin Garnett,PF,23,MIN,4,4,171,30,78,0.385,2,3,0.667,28,75,0.373,0.397,13,16,0.813,13,30,43,35,5,3,11,12,75
2000,Dean Garrett,C,33,MIN,3,0,16,1,2,0.5,0,0,0,1,2,0.5,0.5,1,2,0.5,1,1,2,0,0,1,0,2,3
2000,Matt Geiger,C,30,PHI,8,0,128,25,50,0.5,0,0,0,25,50,0.5,0.5,20,25,0.8,17,23,40,2,5,2,5,23,70
2000,Devean George,SF,22,LAL,9,0,45,7,19,0.368,2,10,0.2,5,9,0.556,0.421,6,11,0.545,4,6,10,2,1,0,3,5,22
2000,Armen Gilliam,PF,35,UTA,10,0,132,15,46,0.326,0,0,0,15,46,0.326,0.326,5,13,0.385,6,23,29,4,4,4,11,15,35
2000,Brian Grant,PF,27,POR,16,0,320,29,65,0.446,0,0,0,29,65,0.446,0.446,29,39,0.744,37,55,92,8,6,6,17,53,87
2000,Gary Grant,PG,34,POR,2,0,8,0,2,0,0,0,0,0,2,0,0,1,2,0.5,0,0,0,1,0,0,0,0,1
2000,Horace Grant,PF,34,SEA,5,5,185,11,27,0.407,0,0,0,11,27,0.407,0.407,2,4,0.5,8,23,31,10,8,5,1,12,24
2000,A.C. Green,PF,36,LAL,23,23,429,37,90,0.411,0,0,0,37,90,0.411,0.411,16,23,0.696,43,53,96,13,14,3,9,44,90
2000,Darvin Ham,SF,26,MIL,5,5,144,11,17,0.647,0,1,0,11,16,0.688,0.647,3,9,0.333,17,12,29,7,1,8,7,22,25
2000,Tom Hammonds,PF,32,MIN,1,0,2,0,0,,0,0,0,0,0,0,,0,0,0,0,0,0,0,0,0,0,0,0
2000,Anfernee Hardaway,SG,28,PHO,9,9,386,67,145,0.462,5,19,0.263,62,126,0.492,0.479,44,62,0.71,14,30,44,51,14,9,25,29,183
2000,Tim Hardaway,PG,33,MIA,7,7,182,20,68,0.294,7,34,0.206,13,34,0.382,0.346,7,10,0.7,1,14,15,33,5,0,11,10,54
2000,Ron Harper,PG,36,LAL,23,23,643,78,181,0.431,9,39,0.231,69,142,0.486,0.456,33,47,0.702,30,55,85,73,23,13,28,63,198
2000,Grant Hill*,SF,27,DET,2,2,55,6,16,0.375,1,2,0.5,5,14,0.357,0.406,9,10,0.9,0,11,11,9,1,0,10,7,22
2000,Tyrone Hill,PF,31,PHI,10,10,352,46,100,0.46,0,1,0,46,99,0.465,0.46,31,44,0.705,36,61,97,9,9,1,12,38,123
2000,Jeff Hornacek,SG,36,UTA,10,10,297,43,102,0.422,9,22,0.409,34,80,0.425,0.466,20,24,0.833,9,21,30,33,10,0,15,28,115
2000,Robert Horry,PF,29,LAL,23,0,618,59,145,0.407,17,59,0.288,42,86,0.488,0.466,40,57,0.702,38,85,123,58,20,19,30,88,175
2000,Allan Houston,SG,28,NYK,16,16,654,103,235,0.438,19,38,0.5,84,197,0.426,0.479,56,65,0.862,3,49,52,26,19,3,36,42,281
2000,Lindsey Hunter,PG,29,DET,3,3,93,10,32,0.313,1,9,0.111,9,23,0.391,0.328,4,6,0.667,0,7,7,5,5,1,5,4,25
2000,Allen Iverson*,SG,24,PHI,10,10,444,91,237,0.384,12,39,0.308,79,198,0.399,0.409,68,92,0.739,14,26,40,45,12,1,32,24,262
2000,Bobby Jackson,PG,26,MIN,3,0,30,4,8,0.5,1,3,0.333,3,5,0.6,0.563,6,6,1,0,5,5,4,2,1,2,4,15
2000,Jaren Jackson,SG,32,SAS,2,0,19,0,3,0,0,1,0,0,2,0,0,2,4,0.5,0,1,1,2,1,0,0,1,2
2000,Mark Jackson,PG,34,IND,23,23,634,69,176,0.392,21,67,0.313,48,109,0.44,0.452,28,31,0.903,12,74,86,178,19,2,43,42,187
2000,Avery Johnson,PG,34,SAS,4,4,144,19,42,0.452,0,0,0,19,42,0.452,0.452,10,14,0.714,2,7,9,21,4,0,10,10,48
2000,Ervin Johnson,C,32,MIL,5,5,155,10,20,0.5,0,0,0,10,20,0.5,0.5,11,18,0.611,14,35,49,2,6,6,3,19,31
2000,Kevin Johnson,PG,33,PHO,9,0,129,12,37,0.324,0,3,0,12,34,0.353,0.324,5,6,0.833,0,13,13,23,3,1,13,10,29
2000,Larry Johnson,PF,30,NYK,16,16,589,70,152,0.461,13,33,0.394,57,119,0.479,0.503,27,34,0.794,15,65,80,26,8,2,23,47,180
2000,Eddie Jones,SG,28,CHH,4,4,171,22,58,0.379,9,26,0.346,13,32,0.406,0.457,15,16,0.938,4,16,20,19,10,3,5,12,68
2000,Jumaine Jones,SF,20,PHI,4,0,8,1,3,0.333,0,2,0,1,1,1,0.333,0,0,0,0,0,0,0,0,0,0,0,2
2000,Jerome Kersey,SF,37,SAS,2,0,25,1,7,0.143,0,0,0,1,7,0.143,0.143,0,0,0,2,2,4,1,2,1,1,5,2
2000,Jason Kidd*,PG,26,PHO,6,6,229,22,55,0.4,8,22,0.364,14,33,0.424,0.473,7,9,0.778,8,32,40,53,11,1,23,14,59
2000,Travis Knight,C,25,LAL,14,0,48,8,15,0.533,0,0,0,8,15,0.533,0.533,2,6,0.333,3,2,5,0,1,3,6,16,18
2000,Toni Kukoc,SF,31,PHI,10,0,257,36,93,0.387,11,34,0.324,25,59,0.424,0.446,10,17,0.588,7,30,37,17,10,3,15,26,93
2000,Christian Laettner,C,30,DET,3,3,75,7,17,0.412,0,0,0,7,17,0.412,0.412,6,8,0.75,2,13,15,6,0,1,3,14,20
2000,Quincy Lewis,SG,22,UTA,8,0,106,10,27,0.37,2,6,0.333,8,21,0.381,0.407,4,5,0.8,2,13,15,2,3,7,3,24,26
2000,Rashard Lewis,SF,20,SEA,5,5,157,26,59,0.441,9,19,0.474,17,40,0.425,0.517,16,20,0.8,12,19,31,3,5,3,10,11,77
2000,Randy Livingston,PG,24,PHO,7,3,63,6,27,0.222,2,6,0.333,4,21,0.19,0.259,0,0,0,2,5,7,4,4,1,4,6,14
2000,Luc Longley,C,31,PHO,9,9,162,18,51,0.353,0,0,0,18,51,0.353,0.353,2,3,0.667,12,18,30,8,4,4,10,36,38
2000,George Lynch,SF,29,PHI,10,10,293,22,65,0.338,1,7,0.143,21,58,0.362,0.346,14,18,0.778,26,45,71,14,9,5,8,33,59
2000,Todd MacCulloch,C,24,PHI,5,0,24,2,3,0.667,0,0,0,2,3,0.667,0.667,4,6,0.667,3,6,9,0,0,0,0,2,8
2000,Dan Majerle,SG,34,MIA,10,10,372,30,71,0.423,20,50,0.4,10,21,0.476,0.563,10,14,0.714,5,65,70,32,21,1,11,34,90
2000,Karl Malone*,PF,36,UTA,10,10,386,103,198,0.52,2,2,1,101,196,0.515,0.525,64,79,0.81,19,70,89,31,7,7,27,31,272
2000,Danny Manning,PF,33,MIL,1,0,5,0,1,0,0,0,0,0,1,0,0,0,0,0,0,1,1,0,0,0,0,0,0
2000,Shawn Marion,SF,21,PHO,9,9,281,36,86,0.419,1,6,0.167,35,80,0.438,0.424,9,11,0.818,21,58,79,7,6,14,7,17,82
2000,Darrick Martin,PG,28,SAC,2,0,21,3,9,0.333,1,3,0.333,2,6,0.333,0.389,3,4,0.75,1,2,3,2,1,0,3,4,10
2000,Jamal Mashburn,SF,27,MIA,10,10,423,63,157,0.401,13,33,0.394,50,124,0.403,0.443,36,42,0.857,9,37,46,32,11,2,24,30,175
2000,Anthony Mason,SF,33,CHH,4,4,179,18,38,0.474,0,1,0,18,37,0.486,0.474,14,20,0.7,16,23,39,22,4,0,13,13,50
2000,Jelani McCoy,C,22,SEA,3,0,26,2,5,0.4,0,0,0,2,5,0.4,0.4,0,3,0,0,6,6,2,0,0,2,6,4
2000,Tracy McGrady*,SF,20,TOR,3,3,111,17,44,0.386,2,7,0.286,15,37,0.405,0.409,14,16,0.875,10,11,21,9,3,3,10,10,50
2000,Derrick McKey,SF,33,IND,23,0,352,15,32,0.469,1,6,0.167,14,26,0.538,0.484,16,20,0.8,25,54,79,14,7,4,19,45,47
2000,Aaron McKie,SG,27,PHI,10,6,331,50,103,0.485,12,35,0.343,38,68,0.559,0.544,26,31,0.839,4,32,36,46,4,2,16,26,138
2000,Brad Miller,C,23,CHH,4,0,62,9,17,0.529,0,0,0,9,17,0.529,0.529,12,15,0.8,8,5,13,3,0,3,9,11,30
2000,Oliver Miller,C,29,PHO,7,0,37,2,9,0.222,0,3,0,2,6,0.333,0.222,2,4,0.5,2,6,8,1,0,2,2,8,6
2000,Reggie Miller*,SG,34,IND,22,22,892,174,385,0.452,58,147,0.395,116,238,0.487,0.527,121,129,0.938,9,44,53,60,23,10,28,37,527
2000,Terry Mills,PF,32,DET,3,3,77,9,15,0.6,6,9,0.667,3,6,0.5,0.8,1,2,0.5,0,6,6,1,2,0,2,12,25
2000,Sam Mitchell,SF,36,MIN,4,0,68,9,18,0.5,2,5,0.4,7,13,0.538,0.556,3,3,1,2,5,7,2,0,1,4,5,23
2000,Eric Montross,C,28,DET,2,0,5,0,0,,0,0,0,0,0,0,,0,0,0,0,2,2,0,0,0,0,2,0
2000,Mikki Moore,C,24,DET,3,0,42,5,12,0.417,0,0,0,5,12,0.417,0.417,8,8,1,7,5,12,3,1,0,4,9,18
2000,Alonzo Mourning*,C,29,MIA,10,10,376,76,157,0.484,0,1,0,76,156,0.487,0.484,64,96,0.667,31,69,100,14,2,33,24,40,216
2000,Chris Mullin*,SG,36,IND,9,1,90,10,21,0.476,2,8,0.25,8,13,0.615,0.524,9,11,0.818,2,12,14,5,6,1,4,7,31
2000,Rasho Nesterovic,C,23,MIN,4,4,126,11,25,0.44,0,0,0,11,25,0.44,0.44,3,6,0.5,5,8,13,6,3,7,4,20,25
2000,Jermaine O'Neal,C,21,POR,8,0,38,3,11,0.273,0,0,0,3,11,0.273,0.273,6,9,0.667,2,5,7,1,0,3,0,9,12
2000,Shaquille O'Neal*,C,27,LAL,23,23,1000,286,505,0.566,0,0,0,286,505,0.566,0.566,135,296,0.456,119,236,355,71,13,55,56,67,707
2000,Charles Oakley,PF,36,TOR,3,3,110,14,29,0.483,2,7,0.286,12,22,0.545,0.517,0,1,0,2,21,23,11,6,1,5,14,30
2000,Kevin Ollie,PG,27,PHI,10,0,65,6,12,0.5,0,0,0,6,12,0.5,0.5,8,9,0.889,0,5,5,12,2,0,3,5,20
2000,Greg Ostertag,C,26,UTA,8,0,172,10,19,0.526,0,0,0,10,19,0.526,0.526,10,22,0.455,19,26,45,2,2,17,8,20,30
2000,Scott Padgett,PF,23,UTA,8,0,59,6,16,0.375,3,9,0.333,3,7,0.429,0.469,0,0,0,3,14,17,5,1,2,4,10,15
2000,Ruben Patterson,SF,24,SEA,5,0,84,14,26,0.538,0,2,0,14,24,0.583,0.538,13,15,0.867,9,6,15,2,3,2,8,6,41
2000,Gary Payton*,PG,31,SEA,5,5,221,50,113,0.442,9,23,0.391,41,90,0.456,0.482,20,26,0.769,8,30,38,37,9,1,18,16,129
2000,Anthony Peeler,SG,30,MIN,4,0,90,11,24,0.458,2,10,0.2,9,14,0.643,0.5,6,8,0.75,2,7,9,5,3,1,1,9,30
2000,Sam Perkins,PF,38,IND,23,0,417,34,105,0.324,23,66,0.348,11,39,0.282,0.433,19,21,0.905,17,56,73,10,4,6,8,45,110
2000,Chuck Person,SF,35,SEA,2,0,2,0,1,0,0,1,0,0,0,0,0,0,0,0,0,0,0,0,0,0,0,0,0
2000,Scottie Pippen*,SF,34,POR,16,16,614,83,198,0.419,21,70,0.3,62,128,0.484,0.472,52,70,0.743,22,92,114,69,32,7,37,49,239
2000,Scot Pollard,C,24,SAC,5,0,70,9,16,0.563,0,0,0,9,16,0.563,0.563,2,6,0.333,6,10,16,1,2,1,3,18,20
2000,Olden Polynice,C,35,UTA,10,10,260,28,52,0.538,0,0,0,28,52,0.538,0.538,3,6,0.5,24,42,66,5,3,8,13,36,59
2000,Terry Porter,PG,36,SAS,4,0,89,8,31,0.258,4,14,0.286,4,17,0.235,0.323,0,0,0,0,1,1,5,6,0,7,4,20
2000,Theo Ratliff,PF,26,PHI,10,10,374,48,101,0.475,0,0,0,48,101,0.475,0.475,34,47,0.723,28,51,79,9,10,30,17,35,130
2000,Glen Rice,SF,32,LAL,23,23,766,93,228,0.408,28,67,0.418,65,161,0.404,0.469,71,89,0.798,10,82,92,48,15,4,36,50,285
2000,Clifford Robinson,SF,33,PHO,9,9,333,56,145,0.386,13,40,0.325,43,105,0.41,0.431,33,45,0.733,18,36,54,19,11,7,18,35,158
2000,David Robinson*,C,34,SAS,4,4,155,31,83,0.373,0,1,0,31,82,0.378,0.373,32,42,0.762,17,38,55,10,7,12,8,15,94
2000,Eddie Robinson,SF,23,CHH,4,0,45,5,12,0.417,0,0,0,5,12,0.417,0.417,2,2,1,1,2,3,4,2,1,1,2,12
2000,Glenn Robinson,SF,27,MIL,5,5,174,32,79,0.405,2,7,0.286,30,72,0.417,0.418,11,13,0.846,0,21,21,13,8,4,15,18,77
2000,Rodney Rogers,PF,28,PHO,9,0,263,48,115,0.417,8,36,0.222,40,79,0.506,0.452,23,31,0.742,16,45,61,14,10,10,15,31,127
2000,Jalen Rose,SF,27,IND,23,23,964,171,391,0.437,30,70,0.429,141,321,0.439,0.476,107,133,0.805,10,91,101,78,16,11,50,71,479
2000,Malik Rose,PF,25,SAS,4,0,83,8,18,0.444,0,0,0,8,18,0.444,0.444,5,9,0.556,5,14,19,1,2,3,7,12,21
2000,Bryon Russell,SF,29,UTA,10,10,371,48,114,0.421,13,45,0.289,35,69,0.507,0.478,31,41,0.756,9,43,52,21,16,5,15,27,140
2000,Arvydas Sabonis*,C,35,POR,16,16,493,68,150,0.453,6,21,0.286,62,129,0.481,0.473,39,49,0.796,19,88,107,31,14,13,26,59,181
2000,John Salley,C,35,LAL,18,0,78,5,13,0.385,0,0,0,5,13,0.385,0.385,7,10,0.7,9,13,22,4,1,6,4,16,17
2000,Detlef Schrempf,SF,37,POR,15,0,276,22,56,0.393,1,6,0.167,21,50,0.42,0.402,39,47,0.83,10,43,53,30,4,0,15,29,84
2000,Malik Sealy,SF,29,MIN,4,4,122,19,41,0.463,1,3,0.333,18,38,0.474,0.476,11,16,0.688,5,13,18,5,2,0,8,10,50
2000,Brian Shaw,SG,33,LAL,22,1,408,45,107,0.421,16,48,0.333,29,59,0.492,0.495,13,16,0.813,7,44,51,67,11,4,17,46,119
2000,Joe Smith,C,24,MIN,4,0,79,8,17,0.471,0,1,0,8,16,0.5,0.471,2,2,1,7,5,12,1,3,1,4,15,18
2000,Steve Smith,SG,30,POR,16,16,604,88,181,0.486,29,53,0.547,59,128,0.461,0.566,69,78,0.885,13,27,40,44,19,4,27,44,274
2000,Rik Smits,C,33,IND,22,21,461,103,207,0.498,0,1,0,103,206,0.5,0.498,35,40,0.875,24,54,78,21,10,20,27,84,241
2000,Eric Snow,PG,26,PHI,5,4,138,15,31,0.484,3,4,0.75,12,27,0.444,0.532,4,4,1,0,10,10,35,4,1,7,14,37
2000,Latrell Sprewell,SF,29,NYK,16,16,700,110,266,0.414,10,30,0.333,100,236,0.424,0.432,69,88,0.784,12,58,70,58,18,5,37,28,299
2000,Jerry Stackhouse,SG,25,DET,3,3,120,24,59,0.407,3,7,0.429,21,52,0.404,0.432,23,31,0.742,1,11,12,10,2,0,14,4,74
2000,John Stockton*,PG,37,UTA,10,10,350,41,89,0.461,7,18,0.389,34,71,0.479,0.5,23,30,0.767,7,23,30,103,13,2,26,30,112
2000,Peja Stojakovic,SF,22,SAC,5,0,129,16,40,0.4,6,13,0.462,10,27,0.37,0.475,6,9,0.667,2,15,17,3,4,0,5,7,44
2000,Damon Stoudamire,PG,26,POR,16,16,447,56,135,0.415,10,30,0.333,46,105,0.438,0.452,20,24,0.833,8,34,42,58,8,4,19,43,142
2000,Mark Strickland,SF,29,MIA,1,0,10,1,3,0.333,0,0,0,1,3,0.333,0.333,0,2,0,0,0,0,0,2,0,1,0,2
2000,Wally Szczerbiak,SF,22,MIN,4,4,94,12,30,0.4,0,3,0,12,27,0.444,0.4,0,0,0,2,6,8,2,3,1,1,7,24
2000,Zan Tabak,C,29,IND,10,0,47,4,8,0.5,0,0,0,4,8,0.5,0.5,4,4,1,4,12,16,0,0,2,1,10,12
2000,John Thomas,C,24,TOR,1,0,1,0,0,,0,0,0,0,0,0,,0,0,0,0,0,0,0,0,0,0,0,0
2000,Kurt Thomas,PF,27,NYK,16,0,251,31,61,0.508,0,0,0,31,61,0.508,0.508,7,10,0.7,18,32,50,5,3,6,14,44,69
2000,Tim Thomas,SF,22,MIL,5,0,142,29,59,0.492,5,15,0.333,24,44,0.545,0.534,14,17,0.824,6,18,24,10,1,4,1,14,77
2000,Otis Thorpe,PF,37,MIA,10,0,136,13,27,0.481,0,1,0,13,26,0.5,0.481,7,14,0.5,6,23,29,3,0,2,11,29,33
2000,Robert Traylor,PF,22,MIL,1,0,4,0,1,0,0,0,0,0,1,0,0,0,0,0,1,1,2,1,0,1,0,2,0
2000,Mirsad Turkcan,PF,23,MIL,2,0,10,1,5,0.2,0,1,0,1,4,0.25,0.2,2,2,1,0,2,2,0,0,0,3,1,4
2000,Jacque Vaughn,PG,24,UTA,7,0,67,10,28,0.357,1,2,0.5,9,26,0.346,0.375,7,8,0.875,4,8,12,11,4,1,9,5,28
2000,Loy Vaught,PF,31,DET,2,0,16,0,3,0,0,0,0,0,3,0,0,0,0,0,1,5,6,0,2,0,1,1,0
2000,Samaki Walker,PF,23,SAS,4,4,121,14,31,0.452,0,0,0,14,31,0.452,0.452,8,12,0.667,13,32,45,2,1,12,8,13,36
2000,John Wallace,SF,25,NYK,1,0,4,0,2,0,0,0,0,0,2,0,0,0,0,0,0,1,1,0,1,0,1,1,0
2000,Rasheed Wallace,PF,25,POR,16,16,605,110,225,0.489,8,13,0.615,102,212,0.481,0.507,58,75,0.773,31,72,103,28,15,20,23,52,286
2000,Charlie Ward,PG,29,NYK,16,16,439,57,113,0.504,21,53,0.396,36,60,0.6,0.597,15,21,0.714,11,57,68,65,22,5,20,40,150
2000,Clarence Weatherspoon,PF,29,MIA,10,0,170,25,60,0.417,0,0,0,25,60,0.417,0.417,14,24,0.583,18,23,41,1,4,3,8,23,64
2000,Chris Webber,PF,26,SAC,5,5,196,47,110,0.427,1,5,0.2,46,105,0.438,0.432,27,34,0.794,14,34,48,27,8,10,8,14,122
2000,Bonzi Wells,SF,23,POR,14,0,188,37,83,0.446,2,10,0.2,35,73,0.479,0.458,29,41,0.707,12,23,35,13,7,0,16,33,105
2000,David Wesley,PG,29,CHH,4,4,152,16,48,0.333,3,10,0.3,13,38,0.342,0.365,9,9,1,3,9,12,19,8,0,6,17,44
2000,Alvin Williams,PG,25,TOR,1,0,1,0,0,,0,0,0,0,0,0,,0,0,0,0,0,0,0,0,0,0,0,0
2000,Jason Williams,PG,24,SAC,5,5,145,18,48,0.375,8,25,0.32,10,23,0.435,0.458,8,10,0.8,1,7,8,12,3,0,8,8,52
2000,Jerome Williams,PF,26,DET,3,0,73,7,14,0.5,0,0,0,7,14,0.5,0.5,1,8,0.125,7,14,21,2,3,0,3,8,15
2000,Scott Williams,C,31,MIL,5,0,93,23,36,0.639,0,0,0,23,36,0.639,0.639,5,6,0.833,9,19,28,2,2,5,4,16,51
2000,Shammond Williams,PG,24,SEA,5,2,99,18,33,0.545,7,11,0.636,11,22,0.5,0.652,8,11,0.727,2,9,11,18,8,0,6,3,51
2000,Corliss Williamson,SF,26,SAC,5,5,87,11,16,0.688,0,0,0,11,16,0.688,0.688,11,12,0.917,4,11,15,1,1,0,5,8,33
2000,Kevin Willis,PF,37,TOR,3,0,76,12,33,0.364,0,0,0,12,33,0.364,0.364,15,20,0.75,6,20,26,1,2,0,2,11,39
2001,Ray Allen*,SG,25,MIL,18,18,768,158,331,0.477,57,119,0.479,101,212,0.476,0.563,79,86,0.919,19,55,74,108,24,10,43,44,452
2001,Rafer Alston,PG,24,MIL,5,0,8,0,1,0,0,0,,0,1,0,0,0,0,,0,0,0,1,0,0,2,0,0
2001,John Amaechi,C,30,ORL,4,0,29,3,8,0.375,0,0,,3,8,0.375,0.375,3,4,0.75,1,2,3,3,3,2,0,2,9
2001,Derek Anderson,SG,26,SAS,7,7,194,16,61,0.262,6,22,0.273,10,39,0.256,0.311,16,21,0.762,3,16,19,17,3,0,15,10,54
2001,Greg Anthony,PG,33,POR,2,0,17,2,6,0.333,1,3,0.333,1,3,0.333,0.417,0,0,,0,0,0,0,1,0,1,2,5
2001,Darrell Armstrong,PG,32,ORL,4,4,167,17,45,0.378,7,19,0.368,10,26,0.385,0.456,12,13,0.923,5,17,22,19,8,2,11,10,53
2001,Stacey Augmon,SG,32,POR,2,0,28,4,10,0.4,0,0,,4,10,0.4,0.4,2,2,1,1,3,4,4,1,0,1,3,10
2001,William Avery,PG,21,MIN,2,0,12,3,6,0.5,1,2,0.5,2,4,0.5,0.583,0,0,,0,1,1,2,0,1,0,0,7
2001,Jon Barry,SG,31,SAC,7,0,55,7,17,0.412,2,7,0.286,5,10,0.5,0.471,0,0,,3,0,3,4,1,0,3,7,16
2001,Raja Bell,SG,24,PHI,15,0,124,12,27,0.444,2,8,0.25,10,19,0.526,0.481,8,14,0.571,4,9,13,7,15,0,5,20,34
2001,Jonathan Bender,SF,20,IND,1,0,4,0,1,0,0,0,,0,1,0,0,0,0,,0,0,0,0,0,0,0,1,0
2001,David Benoit,SF,32,UTA,4,0,61,7,19,0.368,2,6,0.333,5,13,0.385,0.421,7,7,1,1,6,7,2,0,2,2,6,23
2001,Travis Best,PG,28,IND,4,4,163,17,39,0.436,1,3,0.333,16,36,0.444,0.449,4,4,1,6,13,19,37,4,0,6,15,39
2001,Chauncey Billups,SG,24,MIN,3,0,26,1,6,0.167,0,1,0,1,5,0.2,0.167,1,1,1,1,4,5,2,0,0,1,5,3
2001,Calvin Booth,C,24,DAL,10,0,137,15,37,0.405,0,0,,15,37,0.405,0.405,8,9,0.889,16,12,28,2,7,6,4,29,38
2001,Bruce Bowen,SF,29,MIA,3,3,58,5,16,0.313,2,8,0.25,3,8,0.375,0.375,0,0,,1,1,2,2,2,2,2,8,12
2001,Shawn Bradley,C,28,DAL,10,10,256,27,51,0.529,0,0,,27,51,0.529,0.529,10,13,0.769,24,47,71,5,4,30,10,37,64
2001,Terrell Brandon,PG,30,MIN,4,4,153,27,62,0.435,4,9,0.444,23,53,0.434,0.468,3,3,1,2,15,17,25,4,2,8,10,61
2001,Dee Brown,PG,32,ORL,3,0,54,6,13,0.462,6,11,0.545,0,2,0,0.692,0,0,,0,3,3,4,2,0,1,3,18
2001,P.J. Brown,C,31,CHH,10,10,385,28,67,0.418,0,0,,28,67,0.418,0.418,24,29,0.828,41,59,100,11,12,14,12,31,80
2001,Rick Brunson,PG,28,NYK,2,0,4,0,1,0,0,0,,0,1,0,0,3,4,0.75,0,0,0,0,0,0,1,0,3
2001,Kobe Bryant,SG,22,LAL,16,16,694,168,358,0.469,11,34,0.324,157,324,0.485,0.485,124,151,0.821,29,87,116,97,25,12,51,53,471
2001,Mark Bryant,PF,35,DAL,4,0,34,1,2,0.5,0,0,,1,2,0.5,0.5,0,0,,3,3,6,0,1,0,1,6,2
2001,Greg Buckner,SG,24,DAL,5,0,75,11,23,0.478,1,3,0.333,10,20,0.5,0.5,7,10,0.7,8,13,21,3,5,0,2,12,30
2001,Rodney Buford,SF,23,PHI,15,0,72,8,24,0.333,3,6,0.5,5,18,0.278,0.396,2,2,1,5,7,12,3,4,1,4,15,21
2001,Scott Burrell,SF,30,CHH,2,0,12,2,3,0.667,0,1,0,2,2,1,0.667,1,2,0.5,0,3,3,1,2,0,0,0,5
2001,Jason Caffey,PF,27,MIL,18,0,297,24,63,0.381,0,0,,24,63,0.381,0.381,20,31,0.645,31,43,74,14,3,5,15,44,68
2001,Marcus Camby,C,26,NYK,4,4,141,10,26,0.385,0,0,,10,26,0.385,0.385,5,13,0.385,4,28,32,7,2,9,2,18,25
2001,Elden Campbell,PF,32,CHH,10,10,287,42,106,0.396,0,0,,42,106,0.396,0.396,37,49,0.755,27,52,79,7,5,11,17,37,121
2001,Anthony Carter,PG,25,MIA,3,1,69,9,19,0.474,0,1,0,9,18,0.5,0.474,0,0,,0,6,6,11,2,1,10,9,18
2001,Vince Carter,SF,24,TOR,12,12,539,122,280,0.436,25,61,0.41,97,219,0.443,0.48,58,74,0.784,37,41,78,56,20,20,27,45,327
2001,Sam Cassell,PG,31,MIL,18,18,682,110,278,0.396,10,30,0.333,100,248,0.403,0.414,84,97,0.866,12,71,83,120,19,3,52,76,314
2001,Duane Causwell,C,32,MIA,1,0,5,0,1,0,0,0,,0,1,0,0,0,0,,0,3,3,0,0,0,0,1,0
2001,Cedric Ceballos,SF,31,MIA,3,0,15,2,7,0.286,0,0,,2,7,0.286,0.286,1,2,0.5,3,3,6,1,0,0,1,3,5
2001,Chris Childs,PG,33,TOR,12,9,380,37,90,0.411,15,36,0.417,22,54,0.407,0.494,20,23,0.87,2,36,38,78,12,3,35,48,109
2001,Doug Christie,SG,30,SAC,8,8,304,25,68,0.368,5,17,0.294,20,51,0.392,0.404,24,29,0.828,7,28,35,26,20,9,19,31,79
2001,Keon Clark,PF,25,TOR,11,0,103,11,30,0.367,0,0,,11,30,0.367,0.367,13,20,0.65,7,16,23,6,2,3,4,16,35
2001,Derrick Coleman,PF,33,CHH,5,0,88,9,34,0.265,2,8,0.25,7,26,0.269,0.294,7,9,0.778,9,16,25,6,4,2,5,12,27
2001,Austin Croshere,PF,25,IND,4,0,129,14,35,0.4,2,10,0.2,12,25,0.48,0.429,13,15,0.867,5,15,20,6,4,2,9,15,43
2001,John Crotty,PG,31,UTA,4,0,19,0,3,0,0,0,,0,3,0,0,3,3,1,1,2,3,3,1,1,0,3,3
2001,Dell Curry,SG,36,TOR,12,0,182,27,64,0.422,14,37,0.378,13,27,0.481,0.531,10,12,0.833,2,12,14,10,6,1,11,10,78
2001,Antonio Daniels,PG,25,SAS,13,8,406,63,131,0.481,17,46,0.37,46,85,0.541,0.546,33,35,0.943,4,22,26,38,7,1,13,22,176
2001,Antonio Davis,C,32,TOR,12,12,485,77,154,0.5,0,0,,77,154,0.5,0.5,43,53,0.811,41,92,133,23,10,22,21,35,197
2001,Baron Davis,PG,21,CHH,10,10,397,59,123,0.48,20,50,0.4,39,73,0.534,0.561,40,56,0.714,9,35,44,58,28,5,22,33,178
2001,Dale Davis,C,31,POR,2,0,20,0,2,0,0,1,0,0,1,0,0,1,2,0.5,3,1,4,0,1,0,1,7,1
2001,Andrew DeClercq,C,27,ORL,4,4,54,8,14,0.571,0,0,,8,14,0.571,0.571,4,8,0.5,7,9,16,1,2,2,2,17,20
2001,Vinny Del Negro,PG,34,PHO,3,0,26,4,7,0.571,0,0,,4,7,0.571,0.571,0,0,,0,2,2,5,0,0,0,2,8
2001,Tony Delk,SG,27,PHO,4,0,114,18,43,0.419,4,10,0.4,14,33,0.424,0.465,7,11,0.636,5,11,16,4,3,0,5,7,47
2001,Vlade Divac,C,32,SAC,8,8,225,28,80,0.35,1,3,0.333,27,77,0.351,0.356,29,38,0.763,20,47,67,19,8,12,18,25,86
2001,Michael Doleac,C,23,ORL,4,0,45,6,16,0.375,0,0,,6,16,0.375,0.375,0,0,,4,10,14,1,3,0,2,10,12
2001,Chris Dudley,C,35,PHO,3,0,26,1,2,0.5,0,0,,1,2,0.5,0.5,0,0,,3,4,7,0,1,1,4,1,2
2001,Tim Duncan,PF,24,SAS,13,13,526,120,246,0.488,1,1,1,119,245,0.486,0.49,76,119,0.639,54,134,188,49,14,35,50,43,317
2001,Tyus Edney,PG,27,IND,2,0,10,2,7,0.286,0,1,0,2,6,0.333,0.286,0,1,0,0,0,0,3,1,0,0,1,4
2001,Howard Eisley,SG,28,DAL,9,0,194,19,53,0.358,10,26,0.385,9,27,0.333,0.453,4,4,1,1,11,12,17,5,1,13,18,52
2001,Mario Elie,SG,37,PHO,4,4,103,14,31,0.452,2,13,0.154,12,18,0.667,0.484,6,8,0.75,2,11,13,7,3,1,2,6,36
2001,Sean Elliott,SF,32,SAS,12,0,239,19,51,0.373,8,22,0.364,11,29,0.379,0.451,11,11,1,3,23,26,14,5,6,13,21,57
2001,LaPhonso Ellis,PF,30,MIN,4,0,77,9,23,0.391,0,1,0,9,22,0.409,0.391,6,8,0.75,7,7,14,0,1,3,5,13,24
2001,Danny Ferry,SF,34,SAS,13,11,334,27,68,0.397,21,46,0.457,6,22,0.273,0.551,0,0,,8,33,41,17,4,1,6,32,75
2001,Michael Finley,SF,27,DAL,10,10,434,72,200,0.36,17,47,0.362,55,153,0.359,0.403,36,44,0.818,13,40,53,44,12,2,24,23,197
2001,Derek Fisher,PG,26,LAL,16,16,576,77,159,0.484,35,68,0.515,42,91,0.462,0.594,26,34,0.765,5,56,61,48,21,1,12,44,215
2001,Greg Foster,C,32,LAL,1,0,3,0,0,,0,0,,0,0,,,0,0,,0,1,1,0,0,0,0,1,0
2001,Jeff Foster,C,24,IND,4,2,52,4,9,0.444,0,0,,4,9,0.444,0.444,2,2,1,3,9,12,2,0,3,4,8,10
2001,Rick Fox,SF,31,LAL,16,16,573,58,129,0.45,18,57,0.316,40,72,0.556,0.519,26,30,0.867,13,66,79,57,31,7,36,55,160
2001,Lawrence Funderburke,PF,30,SAC,3,0,17,3,8,0.375,0,0,,3,8,0.375,0.375,1,1,1,4,2,6,0,2,2,1,4,7
2001,Kevin Garnett,PF,24,MIN,4,4,165,27,58,0.466,0,3,0,27,55,0.491,0.466,30,36,0.833,10,38,48,17,4,6,6,13,84
2001,Dean Garrett,C,34,MIN,3,2,41,4,12,0.333,0,0,,4,12,0.333,0.333,5,6,0.833,2,7,9,0,1,1,0,6,13
2001,Pat Garrity,SF,24,ORL,4,0,117,17,36,0.472,10,20,0.5,7,16,0.438,0.611,4,5,0.8,1,4,5,2,0,1,2,11,48
2001,Matt Geiger,C,31,PHI,12,0,100,17,29,0.586,0,0,,17,29,0.586,0.586,4,4,1,10,8,18,7,2,0,5,30,38
2001,Devean George,SF,23,LAL,7,0,27,6,12,0.5,1,2,0.5,5,10,0.5,0.542,1,2,0.5,3,2,5,1,0,0,3,6,14
2001,Brian Grant,C,28,MIA,3,0,84,10,24,0.417,0,0,,10,24,0.417,0.417,10,14,0.714,6,18,24,1,0,5,6,9,30
2001,Horace Grant,PF,35,LAL,16,16,423,37,96,0.385,0,0,,37,96,0.385,0.385,22,30,0.733,40,56,96,19,15,13,15,43,96
2001,A.C. Green,PF,37,MIA,3,0,21,1,3,0.333,0,0,,1,3,0.333,0.333,1,1,1,1,3,4,2,1,0,1,4,3
2001,Tom Gugliotta,PF,31,PHO,4,0,86,8,26,0.308,0,0,,8,26,0.308,0.308,7,9,0.778,4,11,15,3,8,1,5,9,23
2001,Darvin Ham,SF,27,MIL,14,6,132,9,15,0.6,0,0,,9,15,0.6,0.6,11,20,0.55,10,9,19,5,4,7,6,31,29
2001,Tim Hardaway,PG,34,MIA,2,2,36,2,9,0.222,1,3,0.333,1,6,0.167,0.278,0,0,,1,1,2,9,0,0,8,4,5
2001,Ron Harper,PG,37,LAL,6,0,42,5,10,0.5,1,4,0.25,4,6,0.667,0.55,2,3,0.667,1,7,8,4,4,1,1,4,13
2001,Al Harrington,PF,20,IND,3,0,40,2,13,0.154,0,2,0,2,11,0.182,0.154,1,2,0.5,3,1,4,3,0,0,1,8,5
2001,Othella Harrington,C,27,NYK,5,1,77,7,14,0.5,0,0,,7,14,0.5,0.5,4,5,0.8,7,8,15,2,4,2,3,16,18
2001,Antonio Harvey,PF,30,POR,2,0,14,0,1,0,0,0,,0,1,0,0,0,0,,1,5,6,0,0,0,1,4,0
2001,Hersey Hawkins,SG,34,CHH,6,0,50,3,8,0.375,1,4,0.25,2,4,0.5,0.438,5,7,0.714,1,8,9,4,3,0,0,4,12
2001,Tyrone Hill,PF,32,PHI,23,23,742,65,159,0.409,0,1,0,65,158,0.411,0.409,36,53,0.679,54,114,168,10,13,12,26,80,166
2001,Robert Horry,PF,30,LAL,16,0,382,32,87,0.368,17,47,0.362,15,40,0.375,0.466,13,22,0.591,30,53,83,31,22,16,18,50,94
2001,Eddie House,PG,22,MIA,3,0,64,16,40,0.4,2,7,0.286,14,33,0.424,0.425,4,5,0.8,1,4,5,5,3,1,5,7,38
2001,Allan Houston,SG,29,NYK,5,5,189,38,64,0.594,6,11,0.545,32,53,0.604,0.641,22,22,1,0,9,9,7,5,1,10,17,104
2001,Juwan Howard,PF,27,DAL,10,10,391,49,136,0.36,0,0,,49,136,0.36,0.36,36,45,0.8,29,54,83,14,6,5,14,38,134
2001,Troy Hudson,PG,24,ORL,4,0,56,6,21,0.286,0,3,0,6,18,0.333,0.286,5,6,0.833,5,4,9,9,1,0,3,3,17
2001,Lindsey Hunter,PG,30,MIL,18,0,289,24,99,0.242,8,53,0.151,16,46,0.348,0.283,8,11,0.727,2,29,31,34,14,3,13,24,64
2001,Allen Iverson*,SG,25,PHI,22,22,1016,257,661,0.389,48,142,0.338,209,519,0.403,0.425,161,208,0.774,15,89,104,134,52,7,63,55,723
2001,Bobby Jackson,PG,27,SAC,8,0,182,21,48,0.438,4,14,0.286,17,34,0.5,0.479,10,14,0.714,6,20,26,18,8,0,7,18,56
2001,Mark Jackson,PG,35,NYK,5,5,156,20,40,0.5,2,8,0.25,18,32,0.563,0.525,3,3,1,3,23,26,26,8,0,10,6,45
2001,Avery Johnson,PG,35,SAS,13,0,281,34,88,0.386,0,1,0,34,87,0.391,0.386,8,15,0.533,3,13,16,41,10,1,10,24,76
2001,Ervin Johnson,C,33,MIL,18,10,577,39,68,0.574,0,0,,39,68,0.574,0.574,20,32,0.625,59,135,194,10,9,37,12,52,98
2001,Eddie Jones,SG,29,MIA,3,3,108,22,44,0.5,7,16,0.438,15,28,0.536,0.58,6,7,0.857,2,16,18,7,3,1,7,9,57
2001,Jumaine Jones,SF,21,PHI,23,14,447,52,125,0.416,8,32,0.25,44,93,0.473,0.448,15,21,0.714,35,49,84,17,10,11,14,33,127
2001,Steve Kerr,PG,35,SAS,9,0,101,12,25,0.48,5,15,0.333,7,10,0.7,0.58,1,2,0.5,3,6,9,6,4,1,2,8,30
2001,Jason Kidd*,PG,27,PHO,4,4,166,22,69,0.319,4,17,0.235,18,52,0.346,0.348,9,12,0.75,9,15,24,53,8,0,12,13,57
2001,Travis Knight,C,26,NYK,1,0,1,0,0,,0,0,,0,0,,,0,0,,0,0,0,0,0,0,0,1,0
2001,Felipe Lopez,PG,26,MIN,4,0,55,7,22,0.318,1,5,0.2,6,17,0.353,0.341,2,3,0.667,4,7,11,5,4,0,2,5,17
2001,Tyronn Lue,PG,23,LAL,15,0,131,10,29,0.345,5,13,0.385,5,16,0.313,0.431,4,5,0.8,1,9,10,10,12,1,8,11,29
2001,George Lynch,SF,30,PHI,10,8,222,24,50,0.48,0,1,0,24,49,0.49,0.48,9,14,0.643,20,31,51,12,13,2,13,30,57
2001,Todd MacCulloch,C,25,PHI,18,0,109,24,38,0.632,0,0,,24,38,0.632,0.632,8,10,0.8,17,12,29,4,0,3,4,14,56
2001,Mark Madsen,PF,25,LAL,13,0,48,1,13,0.077,0,0,,1,13,0.077,0.077,3,5,0.6,6,4,10,4,0,2,2,4,5
2001,Jamaal Magloire,C,22,CHH,10,0,110,16,28,0.571,0,0,,16,28,0.571,0.571,7,23,0.304,8,20,28,3,0,6,4,20,39
2001,Dan Majerle,SG,35,MIA,3,0,71,5,16,0.313,4,14,0.286,1,2,0.5,0.438,2,4,0.5,3,7,10,5,3,0,2,7,16
2001,Karl Malone*,PF,37,UTA,5,5,199,49,121,0.405,1,2,0.5,48,119,0.403,0.409,39,49,0.796,9,35,44,17,5,4,19,13,138
2001,Danny Manning,PF,34,UTA,5,0,96,19,34,0.559,2,2,1,17,32,0.531,0.588,9,12,0.75,2,9,11,3,3,4,7,21,49
2001,Shawn Marion,SF,22,PHO,4,4,139,23,62,0.371,1,1,1,22,61,0.361,0.379,12,14,0.857,10,23,33,3,6,6,6,13,59
2001,Donyell Marshall,SF,27,UTA,5,5,160,22,54,0.407,1,8,0.125,21,46,0.457,0.417,7,9,0.778,13,25,38,8,2,5,9,19,52
2001,Darrick Martin,PG,29,SAC,2,0,9,0,6,0,0,2,0,0,4,0,0,0,0,,0,0,0,3,0,0,1,1,0
2001,Jamal Mashburn,SF,28,CHH,10,10,419,84,208,0.404,7,21,0.333,77,187,0.412,0.421,74,88,0.841,18,44,62,57,12,3,30,24,249
2001,Anthony Mason,PF,34,MIA,3,3,98,5,13,0.385,0,1,0,5,12,0.417,0.385,6,6,1,1,8,9,4,1,0,7,6,16
2001,Vernon Maxwell,PG,35,DAL,4,0,43,2,10,0.2,0,5,0,2,5,0.4,0.2,0,0,,1,5,6,5,0,0,2,6,4
2001,Tracy McGrady*,SG,21,ORL,4,4,178,51,123,0.415,2,10,0.2,49,113,0.434,0.423,31,38,0.816,6,20,26,33,7,5,8,11,135
2001,Derrick McKey,SF,34,IND,4,0,35,2,5,0.4,1,1,1,1,4,0.25,0.5,1,2,0.5,4,5,9,4,1,0,1,7,6
2001,Aaron McKie,SG,28,PHI,23,16,892,125,301,0.415,27,64,0.422,98,237,0.414,0.46,59,75,0.787,24,95,119,121,34,3,46,67,336
2001,Mike Miller,SF,20,ORL,4,4,112,19,48,0.396,7,18,0.389,12,30,0.4,0.469,3,4,0.75,5,13,18,7,0,3,3,13,48
2001,Reggie Miller*,SG,35,IND,4,4,177,41,90,0.456,15,35,0.429,26,55,0.473,0.539,28,30,0.933,7,13,20,10,3,2,11,3,125
2001,Sam Mitchell,SF,37,MIN,4,0,50,2,10,0.2,0,1,0,2,9,0.222,0.2,2,2,1,1,6,7,3,1,0,1,5,6
2001,Eric Montross,C,29,TOR,5,0,31,2,5,0.4,0,0,,2,5,0.4,0.4,0,0,,5,5,10,1,0,3,2,6,4
2001,Alonzo Mourning*,C,30,MIA,3,3,91,12,25,0.48,0,0,,12,25,0.48,0.48,11,19,0.579,3,13,16,3,0,5,5,9,35
2001,Tracy Murray,SF,29,TOR,2,0,5,1,3,0.333,0,2,0,1,1,1,0.333,0,0,,0,0,0,0,1,0,2,1,2
2001,Dikembe Mutombo*,C,34,PHI,23,23,981,102,208,0.49,0,1,0,102,207,0.493,0.49,115,148,0.777,113,203,316,17,15,72,36,56,319
2001,Eduardo Najera,PF,24,DAL,7,0,44,9,17,0.529,3,4,0.75,6,13,0.462,0.618,0,0,,7,8,15,1,1,1,1,8,21
2001,Steve Nash*,PG,26,DAL,10,10,370,45,108,0.417,16,39,0.41,29,69,0.42,0.491,30,34,0.882,6,26,32,64,6,1,25,19,136
2001,Rasho Nesterovic,C,24,MIN,4,2,49,5,13,0.385,0,0,,5,13,0.385,0.385,0,0,,5,7,12,3,1,3,3,9,10
2001,Dirk Nowitzki,PF,22,DAL,10,10,399,69,163,0.423,13,46,0.283,56,117,0.479,0.463,83,94,0.883,14,67,81,14,11,8,14,37,234
2001,Jermaine O'Neal,C,22,IND,4,4,157,17,39,0.436,0,1,0,17,38,0.447,0.436,5,10,0.5,12,38,50,7,0,10,7,13,39
2001,Shaquille O'Neal*,C,28,LAL,16,16,676,191,344,0.555,0,0,,191,344,0.555,0.555,105,200,0.525,91,156,247,51,7,38,57,55,487
2001,Charles Oakley,PF,37,TOR,12,12,391,47,108,0.435,3,8,0.375,44,100,0.44,0.449,14,17,0.824,20,56,76,21,12,7,22,29,111
2001,Kevin Ollie,PG,28,PHI,23,0,123,10,27,0.37,0,0,,10,27,0.37,0.37,13,14,0.929,2,7,9,23,0,0,8,12,33
2001,Greg Ostertag,C,27,UTA,5,0,64,4,11,0.364,0,0,,4,11,0.364,0.364,0,4,0,6,12,18,1,0,2,2,10,8
2001,Bo Outlaw,PF,29,ORL,4,4,134,16,26,0.615,0,0,,16,26,0.615,0.615,2,11,0.182,11,31,42,9,5,6,9,15,34
2001,Anthony Peeler,SG,31,MIN,4,4,137,14,53,0.264,6,17,0.353,8,36,0.222,0.321,0,0,,3,11,14,7,7,1,6,10,34
2001,Will Perdue,C,35,POR,3,0,5,0,0,,0,0,,0,0,,,0,2,0,1,1,2,0,0,0,0,0,0
2001,Sam Perkins,PF,39,IND,3,0,19,2,8,0.25,1,4,0.25,1,4,0.25,0.313,0,0,,1,3,4,0,0,0,0,3,5
2001,Elliot Perry,PG,31,PHO,2,0,17,6,10,0.6,0,1,0,6,9,0.667,0.6,1,1,1,1,3,4,4,2,0,0,0,13
2001,Morris Peterson,SG,23,TOR,8,3,110,18,35,0.514,4,9,0.444,14,26,0.538,0.571,3,4,0.75,2,10,12,15,6,0,6,10,43
2001,Scottie Pippen*,SF,35,POR,3,3,117,16,38,0.421,3,17,0.176,13,21,0.619,0.461,6,9,0.667,2,15,17,7,8,2,12,14,41
2001,Scot Pollard,C,25,SAC,8,0,141,19,30,0.633,0,0,,19,30,0.633,0.633,10,17,0.588,23,32,55,2,1,7,6,30,48
2001,Olden Polynice,C,36,UTA,5,5,100,16,30,0.533,0,1,0,16,29,0.552,0.533,7,10,0.7,16,3,19,1,1,2,6,12,39
2001,Mark Pope,PF,28,MIL,6,3,46,5,10,0.5,0,1,0,5,9,0.556,0.5,0,0,,5,7,12,2,2,0,0,6,10
2001,Terry Porter,PG,37,SAS,13,13,326,39,86,0.453,13,39,0.333,26,47,0.553,0.529,17,22,0.773,1,23,24,44,11,0,22,15,108
2001,Joel Przybilla,C,21,MIL,1,0,2,0,0,,0,0,,0,0,,,0,0,,0,0,0,0,0,0,0,0,0
2001,Eldridge Recasner,PG,33,CHH,2,0,9,0,1,0,0,0,,0,1,0,0,3,4,0.75,0,1,1,2,0,0,1,0,3
2001,Don Reid,PF,27,ORL,3,0,25,4,5,0.8,0,1,0,4,4,1,0.8,2,6,0.333,5,6,11,0,1,2,2,9,10
2001,Glen Rice,SF,33,NYK,5,0,144,24,52,0.462,6,14,0.429,18,38,0.474,0.519,7,8,0.875,3,19,22,3,3,1,7,10,61
2001,Clifford Robinson,PF,34,PHO,4,4,114,21,50,0.42,4,16,0.25,17,34,0.5,0.46,14,22,0.636,6,10,16,4,6,2,9,14,60
2001,David Robinson*,C,35,SAS,13,13,409,75,159,0.472,0,1,0,75,158,0.475,0.472,66,95,0.695,39,114,153,22,17,31,28,42,216
2001,Eddie Robinson,SF,24,CHH,10,0,192,31,60,0.517,1,3,0.333,30,57,0.526,0.525,6,6,1,9,24,33,9,4,4,5,12,69
2001,Glenn Robinson,SF,28,MIL,18,18,687,138,322,0.429,24,62,0.387,114,260,0.438,0.466,50,56,0.893,26,90,116,60,11,24,46,43,350
2001,Rodney Rogers,SF,29,PHO,4,0,82,12,40,0.3,2,10,0.2,10,30,0.333,0.325,9,14,0.643,3,11,14,2,2,3,5,16,35
2001,Jalen Rose,SF,28,IND,4,4,164,30,79,0.38,5,16,0.313,25,63,0.397,0.411,7,7,1,3,15,18,11,6,1,9,18,72
2001,Malik Rose,PF,26,SAS,13,0,215,23,55,0.418,1,3,0.333,22,52,0.423,0.427,17,20,0.85,16,33,49,4,3,1,10,38,64
2001,Bryon Russell,SF,30,UTA,5,5,214,25,56,0.446,10,22,0.455,15,34,0.441,0.536,11,12,0.917,4,32,36,15,3,1,2,13,71
2001,Arvydas Sabonis*,C,36,POR,3,3,104,14,29,0.483,0,2,0,14,27,0.519,0.483,6,8,0.75,8,17,25,8,1,7,2,12,34
2001,Daniel Santiago,C,24,PHO,1,0,12,1,2,0.5,0,0,,1,2,0.5,0.5,0,0,,1,4,5,0,0,2,1,2,2
2001,Detlef Schrempf,SF,38,POR,3,0,32,4,6,0.667,2,3,0.667,2,3,0.667,0.833,4,6,0.667,0,5,5,1,0,0,2,3,14
2001,Shawnelle Scott,C,28,SAS,7,0,13,1,4,0.25,0,2,0,1,2,0.5,0.25,1,1,1,0,2,2,0,0,0,3,2,3
2001,Brian Shaw,SG,34,LAL,16,0,290,27,72,0.375,10,29,0.345,17,43,0.395,0.444,6,9,0.667,10,45,55,43,10,1,16,37,70
2001,Reggie Slater,PF,30,MIN,4,0,52,6,16,0.375,0,0,,6,16,0.375,0.375,1,2,0.5,5,9,14,0,2,3,3,15,13
2001,Steve Smith,SG,31,POR,3,3,122,16,34,0.471,4,11,0.364,12,23,0.522,0.529,15,16,0.938,5,8,13,7,2,1,10,3,51
2001,Eric Snow,PG,27,PHI,23,9,717,87,210,0.414,0,7,0,87,203,0.429,0.414,40,55,0.727,26,60,86,104,27,2,45,63,214
2001,Felton Spencer,C,33,NYK,2,0,4,0,0,,0,0,,0,0,,,0,0,,0,0,0,0,0,0,0,2,0
2001,Latrell Sprewell,SF,30,NYK,5,5,212,35,86,0.407,3,14,0.214,32,72,0.444,0.424,19,25,0.76,3,12,15,17,5,1,20,17,92
2001,John Starks,SG,35,UTA,3,0,36,4,12,0.333,1,4,0.25,3,8,0.375,0.375,2,2,1,0,3,3,1,1,1,2,5,11
2001,DeShawn Stevenson,SG,19,UTA,1,0,8,1,2,0.5,0,0,,1,2,0.5,0.5,0,0,,0,1,1,0,0,0,1,0,2
2001,Michael Stewart,C,25,TOR,2,0,4,0,1,0,0,0,,0,1,0,0,0,0,,1,0,1,0,0,0,0,0,0
2001,John Stockton*,PG,38,UTA,5,5,186,17,37,0.459,0,8,0,17,29,0.586,0.459,15,21,0.714,11,17,28,57,10,3,7,19,49
2001,Peja Stojakovic,SF,23,SAC,8,8,307,52,128,0.406,9,26,0.346,43,102,0.422,0.441,60,62,0.968,17,34,51,3,5,3,18,17,173
2001,Damon Stoudamire,PG,27,POR,3,3,114,19,46,0.413,2,13,0.154,17,33,0.515,0.435,13,13,1,1,8,9,13,2,1,9,6,53
2001,Rod Strickland,PG,34,POR,2,0,19,2,6,0.333,0,0,,2,6,0.333,0.333,4,6,0.667,2,2,4,2,2,0,1,1,8
2001,Wally Szczerbiak,SF,23,MIN,4,4,143,18,37,0.486,0,1,0,18,36,0.5,0.486,20,25,0.8,4,14,18,10,5,3,12,6,56
2001,Zan Tabak,C,30,IND,2,2,10,0,4,0,0,0,,0,4,0,0,1,2,0.5,3,0,3,0,0,0,0,2,1
2001,Kurt Thomas,PF,28,NYK,5,5,186,25,47,0.532,0,0,,25,47,0.532,0.532,22,31,0.71,17,39,56,9,2,5,9,26,72
2001,Tim Thomas,PF,23,MIL,18,0,479,64,143,0.448,22,51,0.431,42,92,0.457,0.524,53,65,0.815,22,59,81,29,9,10,21,52,203
2001,Otis Thorpe,PF,38,CHH,8,0,57,2,9,0.222,0,0,,2,9,0.222,0.222,0,0,,6,11,17,0,0,0,2,8,4
2001,Jake Tsakalidis,C,21,PHO,4,4,75,6,16,0.375,0,0,,6,16,0.375,0.375,0,0,,10,18,28,0,0,7,1,11,12
2001,Hedo Turkoglu,SF,21,SAC,8,0,141,20,46,0.435,8,14,0.571,12,32,0.375,0.522,12,12,1,7,21,28,11,3,1,6,18,60
2001,Jacque Vaughn,PG,25,UTA,5,0,57,1,10,0.1,1,2,0.5,0,8,0,0.15,0,0,,0,2,2,8,0,1,1,13,3
2001,Samaki Walker,PF,24,SAS,12,0,76,5,15,0.333,0,0,,5,15,0.333,0.333,4,8,0.5,5,9,14,3,1,1,1,12,14
2001,Rasheed Wallace,PF,26,POR,3,3,128,19,51,0.373,4,11,0.364,15,40,0.375,0.412,8,14,0.571,5,19,24,7,1,3,4,9,50
2001,Charlie Ward,PG,30,NYK,5,0,86,8,27,0.296,3,12,0.25,5,15,0.333,0.352,6,6,1,2,5,7,7,2,0,8,8,25
2001,Chris Webber,PF,27,SAC,8,8,348,76,196,0.388,0,1,0,76,195,0.39,0.388,34,49,0.694,34,58,92,25,9,8,31,29,186
2001,David Wesley,SG,30,CHH,10,10,394,63,134,0.47,13,33,0.394,50,101,0.495,0.519,31,41,0.756,4,26,30,39,16,1,14,28,170
2001,Alvin Williams,SG,26,TOR,12,12,486,69,160,0.431,10,28,0.357,59,132,0.447,0.463,17,25,0.68,6,29,35,50,15,8,16,34,165
2001,Jason Williams,PG,25,SAC,8,8,191,26,61,0.426,11,30,0.367,15,31,0.484,0.516,7,7,1,0,18,18,23,8,0,21,14,70
2001,Jerome Williams,PF,27,TOR,11,0,164,12,24,0.5,0,0,,12,24,0.5,0.5,11,22,0.5,20,25,45,9,10,6,6,23,35
2001,Monty Williams,SF,29,ORL,3,0,14,3,4,0.75,0,0,,3,4,0.75,0.75,1,3,0.333,4,2,6,0,0,2,1,2,7
2001,Scott Williams,C,32,MIL,17,17,378,59,120,0.492,0,0,,59,120,0.492,0.492,16,28,0.571,45,77,122,12,11,24,12,57,134
2001,Wang Zhizhi,C,23,DAL,5,0,23,3,8,0.375,1,2,0.5,2,6,0.333,0.438,3,3,1,0,2,2,1,1,1,1,1,10
2002,Victor Alexander,C,32,DET,1,0,3,0,1,0,0,0,,0,1,0,0,0,0,,0,1,1,0,0,0,0,0,0
2002,Derek Anderson,SG,27,POR,3,0,76,13,30,0.433,2,6,0.333,11,24,0.458,0.467,16,18,0.889,3,4,7,7,2,0,6,1,44
2002,Kenny Anderson,PG,31,BOS,16,16,560,82,197,0.416,0,0,,82,197,0.416,0.416,28,35,0.8,13,37,50,76,21,0,28,58,192
2002,Darrell Armstrong,PG,33,ORL,4,4,158,20,42,0.476,4,17,0.235,16,25,0.64,0.524,17,21,0.81,3,8,11,13,5,0,7,14,61
2002,Chucky Atkins,PG,27,DET,10,10,294,43,118,0.364,14,39,0.359,29,79,0.367,0.424,13,17,0.765,5,19,24,34,6,1,14,25,113
2002,Stacey Augmon,SG,33,CHH,9,0,152,16,41,0.39,0,0,,16,41,0.39,0.39,16,21,0.762,7,20,27,13,10,1,12,21,48
2002,Vin Baker,C,30,SEA,5,4,144,29,58,0.5,1,1,1,28,57,0.491,0.509,7,9,0.778,11,14,25,4,3,6,4,23,66
2002,Dana Barros,PG,34,DET,4,0,6,1,3,0.333,0,1,0,1,2,0.5,0.333,0,0,,0,0,0,1,0,0,0,2,2
2002,Brent Barry,SG,30,SEA,5,5,149,14,34,0.412,7,16,0.438,7,18,0.389,0.515,4,4,1,6,17,23,14,3,4,9,12,39
2002,Jon Barry,SG,32,DET,10,0,177,29,61,0.475,17,38,0.447,12,23,0.522,0.615,5,8,0.625,4,16,20,21,5,1,19,14,80
2002,Tony Battie,C,25,BOS,16,16,443,42,86,0.488,0,0,,42,86,0.488,0.488,13,21,0.619,39,82,121,13,10,30,11,51,97
2002,Raja Bell,SG,25,PHI,3,0,8,1,3,0.333,0,2,0,1,1,1,0.333,0,0,,1,0,1,0,0,0,0,0,2
2002,Jonathan Bender,SF,21,IND,5,0,45,3,6,0.5,0,1,0,3,5,0.6,0.5,0,0,,0,4,4,2,2,3,5,6,6
2002,Mike Bibby,PG,23,SAC,16,16,661,114,257,0.444,25,59,0.424,89,198,0.449,0.492,71,86,0.826,14,46,60,80,23,3,37,30,324
2002,Chauncey Billups,PG,25,MIN,3,3,134,23,51,0.451,6,15,0.4,17,36,0.472,0.51,14,20,0.7,1,14,15,17,3,1,9,14,66
2002,Corie Blount,PF,33,PHI,5,0,88,2,8,0.25,0,0,,2,8,0.25,0.25,3,4,0.75,10,4,14,2,2,2,4,9,7
2002,Mark Blount,C,26,BOS,4,0,39,2,4,0.5,0,0,,2,4,0.5,0.5,2,2,1,3,4,7,1,2,2,1,7,6
2002,Bruce Bowen,SF,30,SAS,10,10,345,25,61,0.41,11,25,0.44,14,36,0.389,0.5,7,14,0.5,9,24,33,14,11,7,7,28,68
2002,Michael Bradley,PF,22,TOR,1,0,3,0,0,,0,0,,0,0,,,0,0,,0,1,1,1,0,0,0,1,0
2002,Shawn Bradley,C,29,DAL,7,0,25,3,6,0.5,0,0,,3,6,0.5,0.5,0,0,,1,4,5,0,0,1,1,9,6
2002,Jamison Brewer,SG,21,IND,2,0,6,0,2,0,0,0,,0,2,0,0,1,2,0.5,2,2,4,1,0,0,1,3,1
2002,Chucky Brown,SF,33,SAC,1,0,1,0,0,,0,0,,0,0,,,0,0,,0,1,1,0,0,0,0,1,0
2002,Kedrick Brown,SF,20,BOS,2,0,3,2,2,1,1,1,1,1,1,1,1.25,0,0,,0,0,0,0,0,1,0,0,5
2002,P.J. Brown,C,32,CHH,9,9,331,32,75,0.427,0,0,,32,75,0.427,0.427,28,37,0.757,29,57,86,14,6,12,8,37,92
2002,Rick Brunson,PG,29,POR,2,0,2,0,0,,0,0,,0,0,,,0,0,,0,0,0,0,0,0,0,0,0
2002,Kobe Bryant,SG,23,LAL,19,19,833,187,431,0.434,22,58,0.379,165,373,0.442,0.459,110,145,0.759,28,83,111,87,27,17,54,65,506
2002,Mark Bryant,PF,36,SAS,9,4,91,9,20,0.45,0,0,,9,20,0.45,0.45,3,6,0.5,8,4,12,1,1,2,1,14,21
2002,Greg Buckner,SG,25,DAL,7,0,105,12,25,0.48,0,1,0,12,24,0.5,0.48,3,4,0.75,13,13,26,4,3,1,3,15,27
2002,Jud Buechler,SF,33,ORL,2,0,10,0,0,,0,0,,0,0,,,0,0,,0,1,1,1,1,0,0,0,0
2002,Elden Campbell,PF,33,CHH,9,9,254,49,110,0.445,0,1,0,49,109,0.45,0.445,24,34,0.706,14,46,60,16,6,23,17,34,122
2002,Chris Childs,PG,34,TOR,5,4,163,21,54,0.389,8,17,0.471,13,37,0.351,0.463,9,10,0.9,2,17,19,37,4,0,20,15,59
2002,Doug Christie,SG,31,SAC,16,16,644,54,132,0.409,17,64,0.266,37,68,0.544,0.473,52,65,0.8,19,73,92,79,33,9,44,64,177
2002,Keon Clark,C,26,TOR,5,5,174,26,48,0.542,0,0,,26,48,0.542,0.542,15,16,0.938,14,26,40,8,2,8,14,19,67
2002,Speedy Claxton,PG,23,PHI,5,0,49,4,12,0.333,0,1,0,4,11,0.364,0.333,4,6,0.667,1,0,1,14,5,0,3,8,12
2002,Derrick Coleman,PF,34,PHI,5,5,191,22,42,0.524,4,13,0.308,18,29,0.621,0.571,16,20,0.8,15,31,46,10,1,7,5,10,64
2002,Jarron Collins,C,23,UTA,4,4,47,10,18,0.556,0,0,,10,18,0.556,0.556,2,2,1,4,3,7,0,0,0,4,11,22
2002,Jason Collins,C,23,NJN,17,0,227,12,33,0.364,0,0,,12,33,0.364,0.364,25,38,0.658,24,17,41,7,5,6,12,48,49
2002,Austin Croshere,PF,26,IND,4,0,59,8,20,0.4,2,6,0.333,6,14,0.429,0.45,6,8,0.75,4,10,14,2,1,1,6,7,24
2002,Vonteego Cummings,PG,25,PHI,1,0,1,0,0,,0,0,,0,0,,,0,0,,0,0,0,0,0,0,0,0,0
2002,Dell Curry,SG,37,TOR,4,0,59,10,25,0.4,4,5,0.8,6,20,0.3,0.48,4,4,1,0,5,5,4,5,2,3,4,28
2002,Michael Curry,SG,33,DET,10,10,221,22,39,0.564,5,13,0.385,17,26,0.654,0.628,8,11,0.727,1,13,14,12,4,0,5,32,57
2002,Antonio Daniels,SG,26,SAS,10,0,224,35,77,0.455,6,16,0.375,29,61,0.475,0.494,19,22,0.864,3,24,27,15,7,3,5,13,95
2002,Antonio Davis,PF,33,TOR,5,5,202,34,75,0.453,0,0,,34,75,0.453,0.453,17,28,0.607,16,37,53,7,2,5,10,17,85
2002,Baron Davis,PG,22,CHH,9,9,401,71,188,0.378,21,62,0.339,50,126,0.397,0.434,40,67,0.597,16,47,63,71,32,5,27,36,203
2002,Dale Davis,C,32,POR,3,3,70,3,11,0.273,0,0,,3,11,0.273,0.273,1,2,0.5,6,14,20,4,4,3,2,16,7
2002,Andrew DeClercq,C,28,ORL,2,0,9,0,0,,0,0,,0,0,,,0,2,0,0,0,0,0,0,0,1,3,0
2002,Tony Delk,SG,28,BOS,14,0,227,23,65,0.354,13,33,0.394,10,32,0.313,0.454,7,12,0.583,8,26,34,16,8,5,15,13,66
2002,Vlade Divac,C,33,SAC,16,16,535,70,151,0.464,2,7,0.286,68,144,0.472,0.47,74,98,0.755,46,103,149,27,18,20,37,76,216
2002,Bryce Drew,PG,27,CHH,2,0,5,1,1,1,0,0,,1,1,1,1,0,0,,0,0,0,2,0,0,0,0,2
2002,Predrag Drobnjak,C,26,SEA,3,1,38,4,12,0.333,0,0,,4,12,0.333,0.333,2,4,0.5,3,5,8,2,1,0,1,2,10
2002,Chris Dudley,C,36,POR,2,0,3,0,1,0,0,0,,0,1,0,0,0,0,,0,2,2,0,0,0,1,1,0
2002,Tim Duncan,PF,25,SAS,9,9,380,82,181,0.453,1,3,0.333,81,178,0.455,0.456,83,101,0.822,28,102,130,45,6,39,37,22,248
2002,Evan Eschmeyer,C,26,DAL,3,0,8,0,1,0,0,0,,0,1,0,0,0,0,,1,1,2,1,0,1,0,2,0
2002,Patrick Ewing*,C,39,ORL,4,0,67,8,25,0.32,0,1,0,8,24,0.333,0.32,10,17,0.588,5,17,22,4,1,4,2,12,26
2002,Danny Ferry,SF,35,SAS,10,0,155,10,33,0.303,7,20,0.35,3,13,0.231,0.409,1,4,0.25,5,15,20,8,0,1,2,19,28
2002,Michael Finley,SF,28,DAL,8,8,373,69,148,0.466,14,37,0.378,55,111,0.495,0.514,45,50,0.9,13,37,50,18,12,4,15,24,197
2002,Derek Fisher,PG,27,LAL,19,19,649,60,168,0.357,29,81,0.358,31,87,0.356,0.443,44,56,0.786,10,52,62,52,19,1,20,49,193
2002,Jeff Foster,C,25,IND,5,0,78,7,13,0.538,2,4,0.5,5,9,0.556,0.615,4,9,0.444,5,19,24,7,3,1,9,13,20
2002,Rick Fox,SF,32,LAL,19,19,652,67,139,0.482,15,43,0.349,52,96,0.542,0.536,37,49,0.755,24,78,102,64,21,6,45,70,186
2002,Lawrence Funderburke,PF,31,SAC,5,0,20,2,3,0.667,0,0,,2,3,0.667,0.667,2,2,1,1,1,2,0,0,0,0,5,6
2002,Kevin Garnett,PF,25,MIN,3,3,130,24,56,0.429,1,2,0.5,23,54,0.426,0.438,23,32,0.719,16,40,56,15,5,5,12,11,72
2002,Pat Garrity,PF,25,ORL,4,4,147,12,32,0.375,7,18,0.389,5,14,0.357,0.484,3,4,0.75,4,26,30,9,2,1,3,18,34
2002,Devean George,SF,24,LAL,19,0,327,38,104,0.365,8,35,0.229,30,69,0.435,0.404,11,15,0.733,24,44,68,11,11,10,12,51,95
2002,Horace Grant,C,36,ORL,4,4,127,8,22,0.364,0,0,,8,22,0.364,0.364,2,2,1,8,23,31,9,3,1,2,7,18
2002,Adrian Griffin,SG,27,DAL,4,1,57,10,17,0.588,0,2,0,10,15,0.667,0.588,0,2,0,2,7,9,4,2,1,3,6,20
2002,Matt Harpring,SF,25,PHI,5,5,119,22,44,0.5,0,0,,22,44,0.5,0.5,7,9,0.778,13,13,26,7,5,0,5,12,51
2002,Lucious Harris,SG,31,NJN,20,0,418,65,133,0.489,8,22,0.364,57,111,0.514,0.519,39,47,0.83,13,41,54,18,13,0,16,29,177
2002,Kirk Haston,PF,22,CHH,2,0,4,1,1,1,0,0,,1,1,1,1,0,0,,0,1,1,0,1,0,0,1,2
2002,Robert Horry,PF,31,LAL,19,14,703,61,136,0.449,24,62,0.387,37,74,0.5,0.537,30,38,0.789,36,118,154,61,33,16,30,66,176
2002,Troy Hudson,PG,25,ORL,4,0,106,18,48,0.375,0,5,0,18,43,0.419,0.375,15,16,0.938,0,4,4,6,0,0,8,4,51
2002,Lindsey Hunter,PG,31,LAL,18,0,132,14,45,0.311,8,29,0.276,6,16,0.375,0.4,0,0,,2,5,7,10,2,0,5,19,36
2002,Allen Iverson*,SG,26,PHI,5,5,209,45,118,0.381,9,27,0.333,36,91,0.396,0.419,51,63,0.81,1,17,18,21,13,0,12,8,150
2002,Bobby Jackson,PG,28,SAC,16,1,374,65,146,0.445,11,43,0.256,54,103,0.524,0.483,34,43,0.791,15,37,52,32,14,3,18,31,175
2002,Jaren Jackson,SG,34,ORL,3,0,5,0,0,,0,0,,0,0,,,0,0,,0,1,1,0,0,0,1,3,0
2002,Jermaine Jackson,SG,25,TOR,4,0,12,2,3,0.667,0,0,,2,3,0.667,0.667,2,6,0.333,0,1,1,0,0,0,3,2,6
2002,Marc Jackson,C,27,MIN,1,0,1,0,0,,0,0,,0,0,,,0,0,,0,0,0,0,0,0,0,1,0
2002,Jerome James,C,26,SEA,5,1,70,9,23,0.391,0,0,,9,23,0.391,0.391,0,2,0,4,8,12,4,0,5,4,18,18
2002,Richard Jefferson,SF,21,NJN,20,0,441,53,114,0.465,0,2,0,53,112,0.473,0.465,33,60,0.55,16,76,92,25,11,9,26,40,139
2002,Anthony Johnson,SG,27,NJN,19,0,161,20,53,0.377,1,10,0.1,19,43,0.442,0.387,9,11,0.818,2,12,14,21,6,0,8,24,50
2002,Alvin Jones,C,23,PHI,2,0,5,0,0,,0,0,,0,0,,,0,0,,0,1,1,0,0,0,1,0,0
2002,Damon Jones,PG,25,DET,10,0,181,16,42,0.381,8,27,0.296,8,15,0.533,0.476,3,4,0.75,1,20,21,25,5,0,6,14,43
2002,Shawn Kemp,PF,32,POR,3,0,35,2,7,0.286,0,0,,2,7,0.286,0.286,7,10,0.7,2,6,8,0,1,0,2,8,11
2002,Steve Kerr,PG,36,POR,3,0,39,6,14,0.429,2,8,0.25,4,6,0.667,0.5,5,5,1,0,4,4,5,1,0,1,6,19
2002,Jason Kidd*,PG,28,NJN,20,20,803,147,354,0.415,17,90,0.189,130,264,0.492,0.439,80,99,0.808,42,122,164,182,34,8,67,40,391
2002,Andrei Kirilenko,SF,20,UTA,4,4,122,11,28,0.393,0,4,0,11,24,0.458,0.393,13,16,0.813,4,11,15,4,7,10,6,10,35
2002,Kerry Kittles,SG,27,NJN,20,20,580,94,216,0.435,18,68,0.265,76,148,0.514,0.477,35,45,0.778,19,44,63,45,32,9,17,37,241
2002,Raef LaFrentz,C,25,DAL,8,8,245,39,78,0.5,6,18,0.333,33,60,0.55,0.538,6,11,0.545,18,43,61,5,2,22,6,39,90
2002,Rusty LaRue,PG,28,UTA,4,0,53,6,16,0.375,2,5,0.4,4,11,0.364,0.438,6,10,0.6,0,6,6,6,1,0,4,6,20
2002,Quincy Lewis,SG,24,UTA,4,0,56,8,23,0.348,1,5,0.2,7,18,0.389,0.37,0,4,0,1,2,3,2,2,1,3,10,17
2002,Rashard Lewis,SF,22,SEA,3,2,79,12,32,0.375,1,6,0.167,11,26,0.423,0.391,13,13,1,4,7,11,2,1,0,2,10,38
2002,Randy Livingston,PG,26,SEA,5,0,80,7,17,0.412,1,3,0.333,6,14,0.429,0.441,5,5,1,1,5,6,10,2,0,1,7,20
2002,Felipe Lopez,SG,27,MIN,3,0,30,1,4,0.25,1,2,0.5,0,2,0,0.375,1,2,0.5,1,0,1,1,1,0,1,6,4
2002,George Lynch,SF,31,CHH,9,7,286,29,59,0.492,2,6,0.333,27,53,0.509,0.508,9,13,0.692,32,44,76,14,10,6,10,26,69
2002,Todd MacCulloch,C,26,NJN,20,20,384,52,106,0.491,0,0,,52,106,0.491,0.491,19,31,0.613,44,60,104,14,5,27,23,51,123
2002,Mark Madsen,PF,26,LAL,7,0,10,0,1,0,0,1,0,0,0,,0,0,0,,0,2,2,0,0,0,1,1,0
2002,Jamaal Magloire,C,23,CHH,8,0,168,22,40,0.55,0,0,,22,40,0.55,0.55,54,71,0.761,17,28,45,5,0,15,17,30,98
2002,Karl Malone*,PF,38,UTA,4,4,163,30,73,0.411,0,1,0,30,72,0.417,0.411,20,28,0.714,3,27,30,18,5,3,11,11,80
2002,Donny Marshall,SF,29,NJN,7,0,14,1,5,0.2,0,4,0,1,1,1,0.2,1,1,1,0,0,0,0,0,0,0,1,3
2002,Donyell Marshall,SF,28,UTA,4,0,124,21,50,0.42,3,6,0.5,18,44,0.409,0.45,12,16,0.75,14,17,31,11,3,6,5,5,57
2002,Kenyon Martin,PF,24,NJN,20,20,749,129,304,0.424,2,9,0.222,127,295,0.431,0.428,76,110,0.691,30,86,116,57,24,25,52,86,336
2002,Jamal Mashburn,SF,29,CHH,1,1,10,0,6,0,0,1,0,0,5,0,0,0,0,,0,1,1,1,0,0,0,0,0
2002,Desmond Mason,SF,24,SEA,5,5,205,24,57,0.421,1,3,0.333,23,54,0.426,0.43,10,17,0.588,5,26,31,9,4,2,5,11,59
2002,Walter McCarty,PF,27,BOS,14,0,194,17,38,0.447,3,18,0.167,14,20,0.7,0.487,7,9,0.778,8,26,34,4,4,0,4,19,44
2002,Tracy McGrady*,SG,22,ORL,4,4,178,42,91,0.462,5,16,0.313,37,75,0.493,0.489,34,46,0.739,6,19,25,22,2,7,13,11,123
2002,Derrick McKey,SF,35,PHI,4,0,40,4,8,0.5,0,0,,4,8,0.5,0.5,0,0,,3,3,6,1,1,2,1,5,8
2002,Aaron McKie,SG,29,PHI,5,0,146,20,46,0.435,6,16,0.375,14,30,0.467,0.5,7,10,0.7,2,16,18,12,10,0,10,12,53
2002,Stanislav Medvedenko,C,22,LAL,7,0,21,3,5,0.6,0,0,,3,5,0.6,0.6,0,0,,1,3,4,0,0,0,1,8,6
2002,Ron Mercer,SG,25,IND,5,0,117,18,36,0.5,0,0,,18,36,0.5,0.5,3,4,0.75,0,10,10,4,1,1,3,9,39
2002,Brad Miller,C,25,IND,5,5,180,20,44,0.455,0,0,,20,44,0.455,0.455,16,20,0.8,17,32,49,7,4,2,7,16,56
2002,Mike Miller,SF,21,ORL,4,1,72,7,21,0.333,1,8,0.125,6,13,0.462,0.357,4,4,1,0,5,5,5,4,0,4,8,19
2002,Reggie Miller*,SG,36,IND,5,5,198,42,83,0.506,13,31,0.419,29,52,0.558,0.584,21,24,0.875,0,16,16,14,8,1,14,10,118
2002,Sam Mitchell,SF,38,MIN,3,2,34,3,9,0.333,0,0,,3,9,0.333,0.333,2,2,1,0,2,2,3,1,1,0,5,8
2002,Dikembe Mutombo*,C,35,PHI,5,5,173,14,31,0.452,0,0,,14,31,0.452,0.452,16,26,0.615,14,39,53,3,2,9,11,16,44
2002,Lee Nailon,SF,26,CHH,9,1,160,27,59,0.458,0,1,0,27,58,0.466,0.458,15,19,0.789,10,14,24,6,3,0,7,17,69
2002,Eduardo Najera,PF,25,DAL,8,4,122,16,23,0.696,0,0,,16,23,0.696,0.696,5,8,0.625,3,10,13,1,3,0,2,22,37
2002,Steve Nash*,PG,27,DAL,8,8,323,51,118,0.432,20,45,0.444,31,73,0.425,0.517,34,35,0.971,7,25,32,70,4,0,30,20,156
2002,Rasho Nesterovic,C,25,MIN,3,3,92,15,31,0.484,0,0,,15,31,0.484,0.484,4,9,0.444,6,14,20,3,1,0,4,10,34
2002,Johnny Newman,SF,38,DAL,3,2,22,1,7,0.143,1,6,0.167,0,1,0,0.214,0,0,,0,0,0,2,0,0,0,5,3
2002,Dirk Nowitzki,C,23,DAL,8,8,357,73,164,0.445,16,28,0.571,57,136,0.419,0.494,65,74,0.878,17,88,105,18,16,6,22,27,227
2002,Jermaine O'Neal,PF,23,IND,5,5,192,34,76,0.447,0,1,0,34,75,0.453,0.447,18,24,0.75,6,32,38,5,4,8,14,24,86
2002,Shaquille O'Neal*,C,29,LAL,19,19,776,203,384,0.529,0,0,,203,384,0.529,0.529,135,208,0.649,67,172,239,54,10,48,62,62,541
2002,Hakeem Olajuwon*,C,39,TOR,5,0,86,12,22,0.545,0,0,,12,22,0.545,0.545,4,6,0.667,9,10,19,2,7,4,6,9,28
2002,Kevin Ollie,PG,29,IND,5,0,118,11,26,0.423,1,2,0.5,10,24,0.417,0.442,6,6,1,0,12,12,23,3,0,5,6,29
2002,Greg Ostertag,C,28,UTA,4,0,87,13,21,0.619,0,0,,13,21,0.619,0.619,1,10,0.1,19,15,34,2,2,6,6,14,27
2002,Olumide Oyedeji,C,20,SEA,3,0,17,4,5,0.8,0,0,,4,5,0.8,0.8,1,5,0.2,4,2,6,1,0,0,1,2,9
2002,Robert Pack,PG,32,MIN,3,0,10,1,5,0.2,0,1,0,1,4,0.25,0.2,1,1,1,0,0,0,0,0,0,1,5,3
2002,Scott Padgett,PF,25,UTA,4,0,47,6,13,0.462,0,3,0,6,10,0.6,0.462,4,5,0.8,7,7,14,2,1,1,5,6,16
2002,Tony Parker,PG,19,SAS,10,10,341,62,136,0.456,10,27,0.37,52,109,0.477,0.493,21,28,0.75,5,24,29,40,9,1,22,22,155
2002,Cherokee Parks,C,29,SAS,5,0,43,4,14,0.286,0,0,,4,14,0.286,0.286,0,1,0,3,8,11,0,0,2,2,6,8
2002,Ruben Patterson,SF,26,POR,3,0,65,5,15,0.333,0,1,0,5,14,0.357,0.333,6,8,0.75,2,5,7,1,3,1,3,7,16
2002,Gary Payton*,PG,33,SEA,5,5,207,45,106,0.425,4,15,0.267,41,91,0.451,0.443,17,29,0.586,10,33,43,29,3,2,13,12,111
2002,Anthony Peeler,SG,32,MIN,3,0,67,9,20,0.45,5,9,0.556,4,11,0.364,0.575,4,6,0.667,1,12,13,2,4,0,6,5,27
2002,Morris Peterson,SF,24,TOR,5,5,154,18,49,0.367,2,17,0.118,16,32,0.5,0.388,8,10,0.8,3,11,14,11,5,3,7,17,46
2002,Paul Pierce,SG,24,BOS,16,16,672,122,303,0.403,30,104,0.288,92,199,0.462,0.452,120,157,0.764,27,110,137,66,27,20,61,52,394
2002,Scottie Pippen*,SF,36,POR,3,3,99,18,39,0.462,6,11,0.545,12,28,0.429,0.538,7,8,0.875,8,20,28,17,4,2,10,14,49
2002,Scot Pollard,C,26,SAC,15,0,193,21,40,0.525,0,0,,21,40,0.525,0.525,8,12,0.667,29,24,53,3,7,5,3,36,50
2002,Terry Porter,PG,38,SAS,10,0,131,13,35,0.371,5,17,0.294,8,18,0.444,0.443,2,4,0.5,1,8,9,8,4,0,5,10,33
2002,Vladimir Radmanovic,PF,21,SEA,5,2,113,14,32,0.438,7,13,0.538,7,19,0.368,0.547,3,3,1,6,12,18,5,1,1,5,11,38
2002,Zach Randolph,PF,20,POR,1,0,1,0,0,,0,0,,0,0,,,0,0,,0,0,0,0,0,0,0,0,0
2002,Zeljko Rebraca,C,29,DET,5,0,69,5,11,0.455,0,0,,5,11,0.455,0.455,11,14,0.786,4,6,10,0,1,1,4,14,21
2002,Don Reid,PF,28,ORL,4,0,38,4,6,0.667,0,0,,4,6,0.667,0.667,1,2,0.5,3,3,6,0,1,2,0,15,9
2002,Mitch Richmond*,SG,36,LAL,2,0,4,1,1,1,0,0,,1,1,1,1,1,2,0.5,0,1,1,0,0,0,1,0,3
2002,Clifford Robinson,PF,35,DET,10,10,409,45,124,0.363,18,53,0.34,27,71,0.38,0.435,24,30,0.8,5,25,30,29,18,19,21,28,132
2002,David Robinson*,C,36,SAS,4,4,81,9,19,0.474,0,0,,9,19,0.474,0.474,0,4,0,6,17,23,5,3,3,2,14,18
2002,Rodney Rogers,SF,30,BOS,16,0,394,46,108,0.426,19,52,0.365,27,56,0.482,0.514,31,35,0.886,28,60,88,34,16,7,22,42,142
2002,Malik Rose,PF,27,SAS,10,3,292,46,96,0.479,0,1,0,46,95,0.484,0.479,37,50,0.74,27,52,79,14,10,5,12,31,129
2002,Bryon Russell,SG,31,UTA,4,4,120,9,36,0.25,6,15,0.4,3,21,0.143,0.333,4,4,1,6,11,17,7,4,0,9,15,28
2002,Brian Scalabrine,PF,23,NJN,6,0,14,1,3,0.333,0,1,0,1,2,0.5,0.333,0,0,,1,2,3,0,0,1,1,0,2
2002,Ansu Sesay,SF,25,SEA,4,0,60,3,8,0.375,0,0,,3,8,0.375,0.375,1,1,1,2,12,14,4,0,4,2,8,7
2002,Brian Shaw,PG,35,LAL,19,0,238,21,63,0.333,9,32,0.281,12,31,0.387,0.405,4,4,1,9,26,35,30,5,6,8,16,55
2002,Charles Smith,SG,26,SAS,4,0,19,2,3,0.667,0,0,,2,3,0.667,0.667,1,2,0.5,2,1,3,2,2,1,3,5,5
2002,Joe Smith,C,26,MIN,3,1,43,3,7,0.429,0,0,,3,7,0.429,0.429,7,8,0.875,4,7,11,0,0,1,1,8,13
2002,Steve Smith,SG,32,SAS,10,10,298,32,87,0.368,10,38,0.263,22,49,0.449,0.425,29,30,0.967,14,20,34,17,8,1,7,20,103
2002,Eric Snow,PG,28,PHI,5,5,171,18,56,0.321,1,6,0.167,17,50,0.34,0.33,17,22,0.773,3,19,22,27,6,0,15,13,54
2002,Jerry Stackhouse,SF,27,DET,10,10,361,53,165,0.321,18,53,0.34,35,112,0.313,0.376,52,63,0.825,9,34,43,43,6,6,27,26,176
2002,Michael Stewart,C,26,TOR,1,0,8,2,2,1,0,0,,2,2,1,1,0,0,,0,3,3,0,0,1,1,2,4
2002,John Stockton*,PG,39,UTA,4,4,141,18,40,0.45,2,7,0.286,16,33,0.485,0.475,12,13,0.923,3,13,16,40,11,1,8,16,50
2002,Peja Stojakovic,SF,24,SAC,10,7,338,50,133,0.376,13,48,0.271,37,85,0.435,0.425,35,39,0.897,16,47,63,10,5,0,19,22,148
2002,Damon Stoudamire,PG,28,POR,3,3,99,5,22,0.227,3,4,0.75,2,18,0.111,0.295,2,3,0.667,1,6,7,10,2,0,4,5,15
2002,Erick Strickland,PG,28,BOS,12,0,118,11,39,0.282,4,20,0.2,7,19,0.368,0.333,9,9,1,2,11,13,17,5,1,9,15,35
2002,Bruno Sundov,C,21,IND,1,0,2,1,1,1,0,0,,1,1,1,1,0,0,,0,0,0,0,0,0,0,0,2
2002,Wally Szczerbiak,SF,24,MIN,3,3,131,21,44,0.477,2,9,0.222,19,35,0.543,0.5,16,18,0.889,9,12,21,6,2,0,8,8,60
2002,Jamaal Tinsley,PG,23,IND,5,5,88,8,19,0.421,0,1,0,8,18,0.444,0.421,2,3,0.667,2,8,10,25,2,0,12,12,18
2002,Robert Traylor,PF,24,CHH,8,0,62,7,20,0.35,0,1,0,7,19,0.368,0.35,4,6,0.667,4,12,16,3,2,2,4,15,18
2002,Gary Trent,PF,27,MIN,3,0,48,8,16,0.5,0,0,,8,16,0.5,0.5,3,6,0.5,5,4,9,1,0,0,3,8,19
2002,Hedo Turkoglu,SF,22,SAC,16,8,443,55,137,0.401,12,34,0.353,43,103,0.417,0.445,16,31,0.516,17,66,83,23,6,9,23,49,138
2002,Nick Van Exel,SG,30,DAL,8,1,264,37,101,0.366,7,34,0.206,30,67,0.448,0.401,8,12,0.667,7,17,24,31,8,0,12,26,89
2002,Keith Van Horn,SF,26,NJN,20,20,643,97,241,0.402,37,84,0.44,60,157,0.382,0.479,35,49,0.714,32,101,133,41,19,9,35,56,266
2002,Antoine Walker,PF,25,BOS,16,16,703,131,319,0.411,42,109,0.385,89,210,0.424,0.476,50,64,0.781,23,115,138,52,24,6,55,56,354
2002,Samaki Walker,PF,25,LAL,19,5,240,24,52,0.462,1,1,1,23,51,0.451,0.471,13,17,0.765,32,46,78,4,2,6,12,42,62
2002,Ben Wallace,C,27,DET,10,10,408,28,59,0.475,0,0,,28,59,0.475,0.475,17,39,0.436,48,113,161,12,19,26,19,24,73
2002,Gerald Wallace,SF,19,SAC,5,0,14,0,1,0,0,0,,0,1,0,0,4,4,1,1,0,1,1,0,1,2,3,4
2002,Rasheed Wallace,PF,27,POR,3,3,125,28,69,0.406,7,17,0.412,21,52,0.404,0.457,13,16,0.813,10,27,37,5,2,2,2,12,76
2002,Chris Webber,PF,28,SAC,16,16,667,160,319,0.502,0,4,0,160,315,0.508,0.502,59,99,0.596,49,124,173,75,14,25,46,64,379
2002,Bonzi Wells,SG,25,POR,3,3,106,14,38,0.368,0,7,0,14,31,0.452,0.368,9,13,0.692,4,8,12,13,6,1,11,11,37
2002,David Wesley,SG,31,CHH,9,9,377,52,129,0.403,17,38,0.447,35,91,0.385,0.469,21,23,0.913,3,14,17,31,10,2,21,30,142
2002,Rodney White,SF,21,DET,1,0,2,0,1,0,0,0,,0,1,0,0,0,0,,0,0,0,0,0,0,1,0,0
2002,Aaron Williams,PF,30,NJN,20,0,416,46,96,0.479,0,1,0,46,95,0.484,0.479,38,46,0.826,24,46,70,16,8,16,23,78,130
2002,Alvin Williams,PG,27,TOR,5,5,196,24,75,0.32,3,14,0.214,21,61,0.344,0.34,9,11,0.818,2,22,24,28,6,2,8,12,60
2002,Eric Williams,SF,29,BOS,16,16,487,47,94,0.5,14,30,0.467,33,64,0.516,0.574,17,23,0.739,18,52,70,21,25,4,11,53,125
2002,Jerome Williams,PF,28,TOR,5,1,143,14,33,0.424,0,0,,14,33,0.424,0.424,8,12,0.667,16,17,33,7,9,1,4,19,36
2002,Monty Williams,SF,30,ORL,4,3,93,14,27,0.519,0,1,0,14,26,0.538,0.519,6,10,0.6,7,15,22,9,3,0,5,8,34
2002,Shammond Williams,SG,26,SEA,3,0,38,6,14,0.429,2,4,0.5,4,10,0.4,0.5,2,3,0.667,1,3,4,3,2,0,4,1,16
2002,Corliss Williamson,SF,28,DET,10,0,269,52,112,0.464,0,2,0,52,110,0.473,0.464,29,38,0.763,19,34,53,10,9,2,22,31,133
2002,Metta World Peace,SF,22,IND,5,5,167,22,54,0.407,6,13,0.462,16,41,0.39,0.463,9,13,0.692,6,24,30,16,13,3,9,19,59
2002,Wang Zhizhi,C,24,DAL,8,0,44,7,16,0.438,3,6,0.5,4,10,0.4,0.531,3,6,0.5,5,3,8,3,0,1,0,11,20
2003,Tariq Abdul-Wahad,SG,28,DAL,8,0,79,9,30,0.3,0,2,0,9,28,0.321,0.3,7,8,0.875,11,11,22,7,0,0,1,6,25
2003,Courtney Alexander,PG,25,NOH,5,0,39,7,16,0.438,1,1,1,6,15,0.4,0.469,3,4,0.75,2,2,4,1,2,0,1,6,18
2003,John Amaechi,C,32,UTA,2,0,16,1,4,0.25,0,0,,1,4,0.25,0.25,2,4,0.5,0,1,1,0,0,0,0,4,4
2003,Derek Anderson,PG,28,POR,2,2,22,1,4,0.25,0,1,0,1,3,0.333,0.25,0,1,0,1,0,1,0,0,0,1,1,2
2003,Kenny Anderson,PG,32,NOH,5,0,51,4,12,0.333,0,0,,4,12,0.333,0.333,3,3,1,0,2,2,9,3,0,4,6,11
2003,Darrell Armstrong,PG,34,ORL,7,1,226,20,44,0.455,6,18,0.333,14,26,0.538,0.523,20,22,0.909,7,10,17,26,6,0,17,22,66
2003,Carlos Arroyo,PG,23,UTA,3,0,27,3,9,0.333,0,0,,3,9,0.333,0.333,3,4,0.75,2,0,2,5,0,0,0,2,9
2003,Chucky Atkins,PG,28,DET,17,3,312,32,91,0.352,18,49,0.367,14,42,0.333,0.451,21,26,0.808,2,18,20,26,17,0,18,39,103
2003,Stacey Augmon,SG,34,NOH,4,0,69,5,15,0.333,0,0,,5,15,0.333,0.333,7,8,0.875,1,9,10,3,3,0,3,8,17
2003,Jon Barry,SG,33,DET,14,0,172,23,54,0.426,15,33,0.455,8,21,0.381,0.565,9,9,1,5,19,24,20,8,1,7,14,70
2003,Tony Battie,C,26,BOS,10,10,213,31,55,0.564,0,3,0,31,52,0.596,0.564,4,8,0.5,13,36,49,5,4,14,7,42,66
2003,Raja Bell,SG,26,DAL,17,7,305,40,73,0.548,6,13,0.462,34,60,0.567,0.589,11,20,0.55,13,38,51,27,5,0,6,41,97
2003,Jonathan Bender,SF,22,IND,3,0,34,5,15,0.333,3,9,0.333,2,6,0.333,0.433,4,6,0.667,3,4,7,0,0,2,0,2,17
2003,Mike Bibby,PG,24,SAC,12,12,404,57,135,0.422,11,39,0.282,46,96,0.479,0.463,27,34,0.794,8,23,31,60,14,5,18,31,152
2003,Chauncey Billups,PG,26,DET,14,14,485,71,190,0.374,26,84,0.31,45,106,0.425,0.442,84,90,0.933,4,43,47,66,9,2,34,38,252
2003,Mark Blount,C,27,BOS,10,0,144,12,22,0.545,0,0,,12,22,0.545,0.545,7,10,0.7,12,24,36,2,11,8,8,20,31
2003,Bruce Bowen,SF,31,SAS,24,24,750,54,145,0.372,35,80,0.438,19,65,0.292,0.493,23,42,0.548,14,55,69,39,20,17,15,52,166
2003,Shawn Bradley,C,30,DAL,17,7,246,20,50,0.4,0,1,0,20,49,0.408,0.4,9,12,0.75,23,42,65,5,3,14,15,48,49
2003,J.R. Bremer,PG,22,BOS,10,0,147,16,56,0.286,8,32,0.25,8,24,0.333,0.357,7,8,0.875,0,15,15,12,3,0,8,12,47
2003,Kedrick Brown,SF,21,BOS,3,0,11,1,4,0.25,0,0,,1,4,0.25,0.25,1,2,0.5,2,0,2,0,1,0,0,0,3
2003,P.J. Brown,PF,33,NOH,6,6,193,21,44,0.477,0,0,,21,44,0.477,0.477,19,25,0.76,20,26,46,6,7,3,5,22,61
2003,Kobe Bryant,SG,24,LAL,12,12,531,137,317,0.432,25,62,0.403,112,255,0.439,0.472,86,104,0.827,16,45,61,62,14,1,42,35,385
2003,Mark Bryant,PF,37,BOS,1,0,2,0,0,,0,0,,0,0,,,0,0,,0,0,0,0,0,0,0,0,0
2003,Greg Buckner,SG,26,PHI,10,0,112,10,31,0.323,2,9,0.222,8,22,0.364,0.355,4,4,1,3,14,17,3,1,2,3,18,26
2003,Pat Burke,C,29,ORL,6,0,43,6,10,0.6,0,0,,6,10,0.6,0.6,5,6,0.833,1,10,11,1,1,0,4,9,17
2003,Sam Cassell,PG,33,MIL,6,6,217,39,83,0.47,11,21,0.524,28,62,0.452,0.536,14,15,0.933,3,16,19,16,3,1,17,20,103
2003,Calbert Cheaney,SG,31,UTA,5,5,122,10,27,0.37,0,0,,10,27,0.37,0.37,2,4,0.5,3,4,7,8,2,1,7,15,22
2003,Doug Christie,SG,32,SAC,12,12,381,37,99,0.374,6,24,0.25,31,75,0.413,0.404,29,31,0.935,15,59,74,55,12,3,22,22,109
2003,Keon Clark,C,27,SAC,12,0,171,20,41,0.488,0,0,,20,41,0.488,0.488,15,21,0.714,14,30,44,4,3,8,13,30,55
2003,Speedy Claxton,PG,24,SAS,24,0,326,46,105,0.438,0,0,,46,105,0.438,0.438,33,44,0.75,7,38,45,45,16,5,24,38,125
2003,Derrick Coleman,C,35,PHI,12,12,449,59,118,0.5,4,10,0.4,55,108,0.509,0.517,41,47,0.872,29,67,96,24,7,16,17,36,163
2003,Bimbo Coles,PG,34,BOS,3,0,9,0,4,0,0,2,0,0,2,0,0,0,0,,0,1,1,2,0,0,0,1,0
2003,Jason Collins,C,24,NJN,20,20,529,33,91,0.363,0,2,0,33,89,0.371,0.363,51,61,0.836,51,74,125,17,13,12,18,74,117
2003,Austin Croshere,PF,27,IND,4,0,46,5,19,0.263,0,6,0,5,13,0.385,0.263,6,7,0.857,8,9,17,3,0,1,3,5,16
2003,Michael Curry,SF,34,DET,15,14,274,16,44,0.364,3,9,0.333,13,35,0.371,0.398,6,7,0.857,3,13,16,17,7,2,5,35,41
2003,Antonio Daniels,SG,27,POR,6,1,98,9,19,0.474,3,5,0.6,6,14,0.429,0.553,1,2,0.5,3,5,8,12,1,1,2,5,22
2003,Baron Davis,PG,23,NOH,5,5,194,37,83,0.446,12,35,0.343,25,48,0.521,0.518,16,22,0.727,4,14,18,42,7,2,15,20,102
2003,Dale Davis,C,33,POR,6,6,162,14,24,0.583,0,0,,14,24,0.583,0.583,17,26,0.654,20,28,48,9,5,2,10,11,45
2003,Andrew DeClercq,C,29,ORL,7,6,104,12,20,0.6,0,0,,12,20,0.6,0.6,4,5,0.8,8,15,23,2,2,5,9,25,28
2003,Tony Delk,PG,29,BOS,10,10,368,54,114,0.474,22,49,0.449,32,65,0.492,0.57,28,32,0.875,5,42,47,36,12,4,13,24,158
2003,Vlade Divac,C,34,SAC,12,12,317,51,91,0.56,0,0,,51,91,0.56,0.56,35,52,0.673,30,39,69,27,8,11,16,38,137
2003,Tim Duncan,PF,26,SAS,24,24,1021,218,412,0.529,0,7,0,218,405,0.538,0.529,157,232,0.677,96,273,369,127,15,79,76,78,593
2003,Evan Eschmeyer,C,27,DAL,5,0,32,3,6,0.5,0,0,,3,6,0.5,0.5,0,0,,2,3,5,2,3,1,0,8,6
2003,Danny Ferry,SF,36,SAS,16,1,101,8,28,0.286,4,14,0.286,4,14,0.286,0.357,0,0,,3,20,23,7,2,0,5,20,20
2003,Michael Finley,SF,29,DAL,20,20,822,131,301,0.435,47,114,0.412,84,187,0.449,0.513,57,66,0.864,25,90,115,60,26,12,31,46,366
2003,Derek Fisher,PG,28,LAL,12,12,424,53,102,0.52,29,47,0.617,24,55,0.436,0.662,18,22,0.818,5,31,36,22,18,1,18,39,153
2003,Jeff Foster,C,26,IND,6,0,38,6,11,0.545,0,0,,6,11,0.545,0.545,2,2,1,4,4,8,2,0,3,0,3,14
2003,Rick Fox,SF,33,LAL,4,4,79,8,18,0.444,5,10,0.5,3,8,0.375,0.583,3,4,0.75,2,4,6,7,1,1,4,15,24
2003,Lawrence Funderburke,PF,32,SAC,6,0,15,3,8,0.375,0,0,,3,8,0.375,0.375,3,4,0.75,3,5,8,0,0,0,1,2,9
2003,Kevin Garnett,PF,26,MIN,6,6,265,71,138,0.514,3,9,0.333,68,129,0.527,0.525,17,28,0.607,11,83,94,31,10,10,18,23,162
2003,Pat Garrity,PF,26,ORL,7,1,163,10,35,0.286,4,17,0.235,6,18,0.333,0.343,4,4,1,4,14,18,5,2,3,5,24,28
2003,Devean George,SF,25,LAL,11,7,318,35,78,0.449,10,30,0.333,25,48,0.521,0.513,8,9,0.889,11,38,49,24,11,4,12,29,88
2003,Kendall Gill,SG,34,MIN,6,0,118,10,27,0.37,2,4,0.5,8,23,0.348,0.407,9,14,0.643,6,7,13,7,4,1,4,12,31
2003,Manu Ginobili,SG,25,SAS,24,0,660,71,184,0.386,28,73,0.384,43,111,0.387,0.462,56,74,0.757,29,63,92,70,41,9,36,62,226
2003,Gordan Giricek,SF,25,ORL,7,7,223,26,56,0.464,5,15,0.333,21,41,0.512,0.509,9,11,0.818,4,18,22,7,2,1,13,27,66
2003,Drew Gooden,PF,21,ORL,7,7,234,36,90,0.4,0,3,0,36,87,0.414,0.4,26,36,0.722,28,61,89,4,3,6,12,23,98
2003,Adrian Griffin,SG,28,DAL,15,2,131,17,41,0.415,1,3,0.333,16,38,0.421,0.427,2,2,1,17,27,44,8,4,0,9,24,37
2003,Tom Gugliotta,PF,33,PHO,2,0,10,2,4,0.5,0,0,,2,4,0.5,0.5,1,2,0.5,0,2,2,0,0,0,0,2,5
2003,Marcus Haislip,PF,22,MIL,2,1,24,4,6,0.667,0,0,,4,6,0.667,0.667,2,4,0.5,2,2,4,2,2,1,1,5,10
2003,Richard Hamilton,SG,24,DET,17,17,659,134,303,0.442,9,27,0.333,125,276,0.453,0.457,106,117,0.906,18,48,66,45,13,1,57,51,383
2003,Anfernee Hardaway,SG,31,PHO,6,6,244,27,70,0.386,9,25,0.36,18,45,0.4,0.45,13,18,0.722,9,27,36,26,13,5,13,26,76
2003,Tim Hardaway,PG,36,IND,4,0,47,5,15,0.333,3,10,0.3,2,5,0.4,0.433,0,0,,0,2,2,9,1,0,3,2,13
2003,Matt Harpring,SF,26,UTA,5,5,156,30,62,0.484,1,7,0.143,29,55,0.527,0.492,13,16,0.813,9,18,27,5,5,1,8,23,74
2003,Al Harrington,SF,22,IND,6,0,103,7,33,0.212,0,4,0,7,29,0.241,0.212,4,6,0.667,7,15,22,5,6,3,10,21,18
2003,Lucious Harris,SG,32,NJN,20,0,435,54,138,0.391,11,33,0.333,43,105,0.41,0.431,36,46,0.783,19,33,52,32,9,0,22,39,155
2003,Tyrone Hill,PF,34,PHI,10,0,141,12,19,0.632,0,0,,12,19,0.632,0.632,4,4,1,12,16,28,2,1,1,6,29,28
2003,Robert Horry,PF,32,LAL,12,10,373,30,94,0.319,2,38,0.053,28,56,0.5,0.33,5,9,0.556,23,57,80,37,15,12,17,37,67
2003,Troy Hudson,PG,26,MIN,6,6,221,44,106,0.415,17,39,0.436,27,67,0.403,0.495,36,38,0.947,1,11,12,33,8,0,16,5,141
2003,Steven Hunter,C,21,ORL,7,0,40,3,10,0.3,0,0,,3,10,0.3,0.3,0,3,0,1,2,3,1,0,3,1,10,6
2003,Allen Iverson*,SG,27,PHI,12,12,557,137,329,0.416,19,55,0.345,118,274,0.431,0.445,87,118,0.737,11,41,52,89,29,1,47,25,380
2003,Bobby Jackson,PG,29,SAC,12,0,331,63,138,0.457,15,43,0.349,48,95,0.505,0.511,31,35,0.886,11,43,54,40,12,1,17,22,172
2003,Jim Jackson,SF,32,SAC,12,0,296,49,98,0.5,13,28,0.464,36,70,0.514,0.566,24,31,0.774,16,31,47,14,8,3,17,34,135
2003,Marc Jackson,C,28,MIN,6,0,110,17,32,0.531,0,1,0,17,31,0.548,0.531,16,19,0.842,10,23,33,8,2,1,9,19,50
2003,Mark Jackson,PG,37,UTA,5,0,83,15,30,0.5,5,9,0.556,10,21,0.476,0.583,1,1,1,2,3,5,16,3,0,4,11,36
2003,Stephen Jackson,SG,24,SAS,24,24,811,108,261,0.414,38,113,0.336,70,148,0.473,0.487,53,66,0.803,19,79,98,65,33,9,68,53,307
2003,Casey Jacobsen,SF,21,PHO,6,0,39,2,10,0.2,2,5,0.4,0,5,0,0.3,0,2,0,1,2,3,2,3,0,1,4,6
2003,Richard Jefferson,SF,22,NJN,20,20,711,110,231,0.476,0,3,0,110,228,0.482,0.476,61,85,0.718,29,98,127,47,16,4,46,67,281
2003,Anthony Johnson,PG,28,NJN,17,0,122,17,31,0.548,3,6,0.5,14,25,0.56,0.597,5,6,0.833,3,9,12,19,2,0,8,15,42
2003,Ervin Johnson,C,35,MIL,6,3,76,3,8,0.375,0,0,,3,8,0.375,0.375,0,0,,6,18,24,3,3,5,3,20,6
2003,Joe Johnson,SG,21,PHO,6,0,164,14,51,0.275,2,13,0.154,12,38,0.316,0.294,2,5,0.4,6,20,26,8,4,2,12,15,32
2003,Shawn Kemp,C,33,ORL,7,0,72,8,21,0.381,0,0,,8,21,0.381,0.381,5,6,0.833,1,14,15,0,0,0,4,13,21
2003,Steve Kerr,PG,37,SAS,10,0,46,7,11,0.636,5,6,0.833,2,5,0.4,0.864,3,4,0.75,1,2,3,6,1,0,1,6,22
2003,Jason Kidd*,PG,29,NJN,20,20,852,137,341,0.402,34,104,0.327,103,237,0.435,0.452,94,114,0.825,36,118,154,163,36,4,79,46,402
2003,Andrei Kirilenko,SF,21,UTA,5,0,145,18,43,0.419,1,7,0.143,17,36,0.472,0.43,21,24,0.875,8,16,24,7,3,10,6,6,58
2003,Kerry Kittles,SG,28,NJN,20,20,613,79,200,0.395,26,63,0.413,53,137,0.387,0.46,32,42,0.762,19,51,70,40,29,5,17,39,216
2003,Toni Kukoc,PF,34,MIL,6,0,184,32,65,0.492,11,29,0.379,21,36,0.583,0.577,14,20,0.7,6,19,25,22,13,1,11,12,89
2003,Raef LaFrentz,C,26,DAL,20,16,491,68,157,0.433,8,40,0.2,60,117,0.513,0.459,16,19,0.842,36,52,88,5,11,43,14,86,160
2003,Grant Long,PF,36,BOS,8,0,34,1,4,0.25,0,0,,1,4,0.25,0.25,0,0,,3,2,5,1,0,0,1,1,2
2003,George Lynch,SG,32,NOH,6,3,163,18,42,0.429,5,18,0.278,13,24,0.542,0.488,1,4,0.25,10,27,37,10,6,5,8,14,42
2003,Mark Madsen,PF,27,LAL,12,2,169,13,31,0.419,0,1,0,13,30,0.433,0.419,7,16,0.438,14,14,28,12,3,2,8,32,33
2003,Jamaal Magloire,C,24,NOH,6,6,188,22,49,0.449,0,0,,22,49,0.449,0.449,25,33,0.758,17,33,50,2,4,6,9,15,69
2003,Karl Malone*,PF,39,UTA,5,5,191,34,84,0.405,0,1,0,34,83,0.41,0.405,30,41,0.732,7,27,34,20,8,2,20,15,98
2003,Danny Manning,PF,36,DET,4,0,14,1,3,0.333,0,1,0,1,2,0.5,0.333,0,0,,1,2,3,0,0,1,0,4,2
2003,Stephon Marbury,PG,25,PHO,6,6,272,51,136,0.375,5,22,0.227,46,114,0.404,0.393,25,33,0.758,6,18,24,34,7,0,23,26,132
2003,Shawn Marion,SF,24,PHO,6,6,282,40,107,0.374,9,28,0.321,31,79,0.392,0.416,22,26,0.846,21,49,70,12,11,11,13,17,111
2003,Kenyon Martin,PF,25,NJN,20,20,777,149,329,0.453,1,11,0.091,148,318,0.465,0.454,79,114,0.693,50,137,187,57,29,31,58,92,378
2003,Jamal Mashburn,SF,30,NOH,4,4,162,34,79,0.43,6,15,0.4,28,64,0.438,0.468,25,35,0.714,0,14,14,21,4,1,10,4,99
2003,Anthony Mason,C,36,MIL,6,0,157,7,17,0.412,0,0,,7,17,0.412,0.412,9,13,0.692,4,16,20,1,3,1,8,17,23
2003,Desmond Mason,SF,25,MIL,6,6,204,28,55,0.509,0,4,0,28,51,0.549,0.509,22,31,0.71,6,36,42,5,6,4,7,19,78
2003,Tony Massenburg,C,35,UTA,5,0,70,10,21,0.476,0,0,,10,21,0.476,0.476,5,9,0.556,7,14,21,2,0,4,5,9,25
2003,Walter McCarty,SF,28,BOS,10,8,352,36,75,0.48,21,52,0.404,15,23,0.652,0.62,6,7,0.857,10,33,43,22,8,5,11,35,99
2003,Tracy McGrady*,SG,23,ORL,7,7,308,74,165,0.448,16,47,0.34,58,118,0.492,0.497,58,75,0.773,10,37,47,33,14,6,26,16,222
2003,Jeff McInnis,PG,28,POR,7,0,99,9,26,0.346,0,3,0,9,23,0.391,0.346,3,4,0.75,5,7,12,19,2,1,6,11,21
2003,Aaron McKie,SF,30,PHI,12,0,315,38,71,0.535,5,9,0.556,33,62,0.532,0.57,12,14,0.857,5,38,43,22,10,2,15,31,93
2003,Stanislav Medvedenko,PF,23,LAL,9,0,73,15,27,0.556,0,0,,15,27,0.556,0.556,4,6,0.667,4,14,18,1,1,1,3,14,34
2003,Ron Mercer,SG,26,IND,6,0,135,16,49,0.327,0,0,,16,49,0.327,0.327,7,8,0.875,2,11,13,7,6,1,5,11,39
2003,Brad Miller,C,26,IND,6,6,135,18,40,0.45,0,0,,18,40,0.45,0.45,16,22,0.727,10,23,33,15,5,0,9,17,52
2003,Reggie Miller*,SG,37,IND,6,6,176,15,53,0.283,4,25,0.16,11,28,0.393,0.321,21,23,0.913,1,13,14,14,1,1,7,9,55
2003,Jerome Moiso,C,24,NOH,4,0,60,10,16,0.625,0,0,,10,16,0.625,0.625,3,4,0.75,8,8,16,5,0,7,4,9,23
2003,Dikembe Mutombo*,C,36,NJN,10,0,115,7,15,0.467,0,0,,7,15,0.467,0.467,4,4,1,8,19,27,6,3,9,8,21,18
2003,Eduardo Najera,SF,26,DAL,19,5,394,39,86,0.453,0,0,,39,86,0.453,0.453,38,48,0.792,36,38,74,15,14,4,16,53,116
2003,Steve Nash*,PG,28,DAL,20,20,729,115,257,0.447,37,76,0.487,78,181,0.431,0.519,55,63,0.873,15,55,70,145,17,1,51,47,322
2003,Rasho Nesterovic,C,26,MIN,6,6,169,19,38,0.5,0,0,,19,38,0.5,0.5,4,6,0.667,9,21,30,4,1,4,5,28,42
2003,Dirk Nowitzki,PF,24,DAL,17,17,722,150,313,0.479,27,61,0.443,123,252,0.488,0.522,103,113,0.912,15,181,196,37,21,16,40,52,430
2003,Jermaine O'Neal,PF,24,IND,6,6,272,43,92,0.467,0,3,0,43,89,0.483,0.467,51,65,0.785,24,81,105,4,3,18,18,22,137
2003,Shaquille O'Neal*,C,30,LAL,12,12,481,121,226,0.535,0,0,,121,226,0.535,0.535,82,132,0.621,63,115,178,44,7,34,35,34,324
2003,Mehmet Okur,PF,23,DET,17,0,323,35,80,0.438,7,13,0.538,28,67,0.418,0.481,17,32,0.531,24,46,70,13,12,12,14,39,94
2003,Greg Ostertag,C,29,UTA,5,5,151,16,36,0.444,0,0,,16,36,0.444,0.444,14,19,0.737,19,24,43,8,3,9,8,17,46
2003,Bo Outlaw,C,31,PHO,6,0,70,1,10,0.1,0,0,,1,10,0.1,0.1,2,4,0.5,6,7,13,5,1,1,6,19,4
2003,Robert Pack,PG,33,NOH,4,0,42,6,13,0.462,0,0,,6,13,0.462,0.462,3,3,1,0,1,1,4,0,0,1,9,15
2003,Scott Padgett,PF,26,UTA,4,0,53,8,19,0.421,2,7,0.286,6,12,0.5,0.474,1,2,0.5,6,3,9,4,3,0,5,6,19
2003,Jannero Pargo,PG,23,LAL,11,0,129,8,24,0.333,4,15,0.267,4,9,0.444,0.417,3,4,0.75,3,6,9,14,8,1,7,22,23
2003,Tony Parker,PG,20,SAS,24,24,814,135,335,0.403,15,56,0.268,120,279,0.43,0.425,67,94,0.713,8,58,66,85,22,3,47,51,352
2003,Ruben Patterson,SF,27,POR,7,0,155,25,52,0.481,0,4,0,25,48,0.521,0.481,20,29,0.69,14,12,26,11,4,1,10,10,70
2003,Gary Payton*,PG,34,MIL,6,6,251,48,112,0.429,1,15,0.067,47,97,0.485,0.433,14,20,0.7,4,14,18,52,8,1,13,18,111
2003,Anthony Peeler,SG,33,MIN,6,5,166,13,38,0.342,2,16,0.125,11,22,0.5,0.368,1,2,0.5,5,16,21,18,4,1,4,14,29
2003,Paul Pierce,SG,25,BOS,10,10,445,77,193,0.399,16,45,0.356,61,148,0.412,0.44,101,117,0.863,11,79,90,67,21,8,44,38,271
2003,Scottie Pippen*,SF,37,POR,4,1,75,9,22,0.409,3,9,0.333,6,13,0.462,0.477,2,2,1,2,9,11,13,0,0,7,8,23
2003,Scot Pollard,C,27,SAC,8,0,91,7,24,0.292,0,0,,7,24,0.292,0.292,10,13,0.769,17,13,30,2,1,7,7,15,24
2003,Tayshaun Prince,SF,22,DET,15,3,382,49,115,0.426,14,48,0.292,35,67,0.522,0.487,29,38,0.763,11,46,57,23,8,13,16,20,141
2003,Joel Przybilla,C,23,MIL,4,3,33,1,1,1,0,0,,1,1,1,1,0,0,,2,8,10,1,0,2,1,11,2
2003,Zach Randolph,PF,21,POR,7,4,205,32,61,0.525,0,0,,32,61,0.525,0.525,33,37,0.892,22,39,61,11,3,2,13,17,97
2003,Zeljko Rebraca,C,30,DET,4,0,29,6,17,0.353,0,0,,6,17,0.353,0.353,5,7,0.714,2,3,5,0,0,0,1,9,17
2003,Michael Redd,SG,23,MIL,6,0,128,21,52,0.404,3,12,0.25,18,40,0.45,0.433,13,14,0.929,9,12,21,11,2,1,7,15,58
2003,Clifford Robinson,PF,36,DET,17,17,525,57,159,0.358,22,59,0.373,35,100,0.35,0.428,22,37,0.595,14,32,46,49,16,13,28,62,158
2003,David Robinson*,C,37,SAS,23,23,539,64,118,0.542,0,0,,64,118,0.542,0.542,52,78,0.667,45,107,152,21,18,31,24,63,180
2003,Rodney Rogers,PF,31,NJN,20,0,350,45,121,0.372,17,42,0.405,28,79,0.354,0.442,27,38,0.711,22,34,56,27,6,3,25,51,134
2003,Malik Rose,PF,28,SAS,24,0,560,75,179,0.419,0,3,0,75,176,0.426,0.419,72,94,0.766,49,89,138,24,16,11,43,72,222
2003,Kareem Rush,PG,22,LAL,9,0,64,11,29,0.379,4,11,0.364,7,18,0.389,0.448,4,4,1,2,1,3,2,1,0,3,2,30
2003,Arvydas Sabonis*,C,38,POR,6,1,86,24,36,0.667,0,0,,24,36,0.667,0.667,12,15,0.8,6,18,24,5,4,4,6,14,60
2003,John Salmons,PG,23,PHI,6,0,16,0,1,0,0,1,0,0,0,,0,0,2,0,0,3,3,0,0,0,2,0,0
2003,Jeryl Sasser,SG,23,ORL,6,0,25,2,7,0.286,1,4,0.25,1,3,0.333,0.357,0,0,,1,4,5,1,1,1,1,1,5
2003,Brian Scalabrine,PF,24,NJN,7,0,20,2,4,0.5,0,1,0,2,3,0.667,0.5,0,0,,1,3,4,0,0,0,1,3,4
2003,Brian Shaw,PG,36,LAL,12,1,215,15,49,0.306,6,26,0.231,9,23,0.391,0.367,2,3,0.667,1,37,38,24,4,5,9,18,38
2003,Brian Skinner,PF,26,PHI,8,0,38,1,6,0.167,0,1,0,1,5,0.2,0.167,4,4,1,3,3,6,0,0,1,2,6,6
2003,Tamar Slay,SG,22,NJN,6,0,11,1,4,0.25,1,1,1,0,3,0,0.375,0,0,,0,0,0,0,0,0,2,1,3
2003,Joe Smith,SF,27,MIN,5,1,40,4,6,0.667,0,0,,4,6,0.667,0.667,6,6,1,0,6,6,0,1,1,3,14,14
2003,Steve Smith,SG,33,SAS,9,0,66,5,24,0.208,2,12,0.167,3,12,0.25,0.25,4,4,1,1,6,7,6,1,0,2,3,16
2003,Eric Snow,PG,29,PHI,12,12,415,43,102,0.422,1,10,0.1,42,92,0.457,0.426,51,58,0.879,9,31,40,67,18,0,30,47,138
2003,DeShawn Stevenson,SG,21,UTA,4,0,37,6,15,0.4,0,2,0,6,13,0.462,0.4,6,6,1,2,5,7,4,1,0,0,3,18
2003,John Stockton*,PG,40,UTA,5,5,149,18,39,0.462,0,1,0,18,38,0.474,0.462,20,20,1,5,11,16,26,8,1,14,13,56
2003,Peja Stojakovic,SF,25,SAC,12,12,486,97,202,0.48,32,70,0.457,65,132,0.492,0.559,51,60,0.85,17,66,83,30,10,5,12,34,277
2003,Damon Stoudamire,PG,29,POR,7,6,232,36,79,0.456,15,31,0.484,21,48,0.438,0.551,20,21,0.952,7,29,36,39,6,2,12,22,107
2003,Amar'e Stoudemire,PF,20,PHO,6,6,203,34,65,0.523,1,1,1,33,64,0.516,0.531,16,28,0.571,16,31,47,7,10,9,19,28,85
2003,Erick Strickland,SG,29,IND,5,0,42,6,14,0.429,1,5,0.2,5,9,0.556,0.464,8,10,0.8,3,4,7,8,1,0,1,4,21
2003,Rod Strickland,PG,36,MIN,6,0,73,11,21,0.524,0,0,,11,21,0.524,0.524,6,6,1,0,6,6,17,4,2,8,5,28
2003,Wally Szczerbiak,SF,25,MIN,6,6,252,29,61,0.475,3,14,0.214,26,47,0.553,0.5,26,30,0.867,6,24,30,13,6,1,18,19,87
2003,Kenny Thomas,PF,25,PHI,12,12,389,54,101,0.535,0,0,,54,101,0.535,0.535,19,29,0.655,42,70,112,11,8,5,19,42,127
2003,Tim Thomas,SF,25,MIL,6,5,191,36,78,0.462,12,21,0.571,24,57,0.421,0.538,23,32,0.719,8,21,29,8,3,6,8,27,107
2003,Jamaal Tinsley,PG,24,IND,6,6,185,20,35,0.571,8,13,0.615,12,22,0.545,0.686,3,6,0.5,6,12,18,39,4,0,8,20,51
2003,Robert Traylor,C,25,NOH,6,0,94,10,22,0.455,0,0,,10,22,0.455,0.455,1,4,0.25,11,19,30,4,3,5,6,17,21
2003,Gary Trent,SF,28,MIN,6,0,42,5,14,0.357,0,0,,5,14,0.357,0.357,4,6,0.667,4,3,7,1,1,0,4,6,14
2003,Hedo Turkoglu,SF,23,SAC,10,5,174,18,50,0.36,4,14,0.286,14,36,0.389,0.4,13,18,0.722,5,24,29,14,12,5,5,19,53
2003,Nick Van Exel,SG,31,DAL,20,3,672,150,326,0.46,44,112,0.393,106,214,0.495,0.528,45,64,0.703,18,50,68,82,12,0,39,47,389
2003,Keith Van Horn,PF,27,PHI,12,12,402,42,110,0.382,14,32,0.438,28,78,0.359,0.445,27,30,0.9,24,66,90,9,10,2,26,41,125
2003,Jacque Vaughn,PG,27,ORL,7,6,131,12,33,0.364,0,1,0,12,32,0.375,0.364,10,13,0.769,1,5,6,25,4,1,9,18,34
2003,Jake Voskuhl,C,25,PHO,6,0,98,12,17,0.706,0,0,,12,17,0.706,0.706,12,13,0.923,9,13,22,2,4,4,6,21,36
2003,Antoine Walker,PF,26,BOS,10,10,440,73,176,0.415,16,45,0.356,57,131,0.435,0.46,11,22,0.5,20,67,87,43,17,4,37,44,173
2003,Samaki Walker,C,26,LAL,9,0,49,2,5,0.4,0,0,,2,5,0.4,0.4,0,0,,4,9,13,2,1,2,3,11,4
2003,Ben Wallace,C,28,DET,17,17,722,53,109,0.486,0,1,0,53,108,0.491,0.486,45,101,0.446,86,191,277,28,42,52,15,50,151
2003,Gerald Wallace,SF,20,SAC,7,0,18,2,5,0.4,0,0,,2,5,0.4,0.4,2,2,1,0,5,5,0,0,1,2,4,6
2003,Rasheed Wallace,PF,28,POR,7,7,260,44,97,0.454,14,35,0.4,30,62,0.484,0.526,20,28,0.714,10,26,36,18,4,5,6,26,122
2003,Chris Webber,PF,29,SAC,7,7,246,67,135,0.496,0,3,0,67,132,0.508,0.496,32,49,0.653,18,40,58,25,10,8,23,25,166
2003,Bonzi Wells,SG,26,POR,7,7,268,49,124,0.395,9,30,0.3,40,94,0.426,0.431,26,39,0.667,14,34,48,26,15,3,21,30,133
2003,David Wesley,SG,32,NOH,6,6,185,29,72,0.403,14,34,0.412,15,38,0.395,0.5,7,7,1,1,6,7,13,5,1,15,23,79
2003,Chris Whitney,PG,31,ORL,7,0,111,8,21,0.381,4,9,0.444,4,12,0.333,0.476,2,2,1,3,8,11,7,2,2,2,21,22
2003,Mike Wilks,PG,23,MIN,4,0,7,1,2,0.5,1,1,1,0,1,0,0.75,0,0,,0,0,0,0,0,0,0,0,3
2003,Aaron Williams,C,31,NJN,19,0,340,50,106,0.472,0,0,,50,106,0.472,0.472,23,31,0.742,33,54,87,18,6,17,13,54,123
2003,Eric Williams,SF,30,BOS,10,2,310,33,88,0.375,3,15,0.2,30,73,0.411,0.392,27,34,0.794,12,20,32,17,9,0,12,42,96
2003,Monty Williams,SF,31,PHI,10,0,96,8,23,0.348,0,1,0,8,22,0.364,0.348,3,4,0.75,7,8,15,0,2,0,4,12,19
2003,Scott Williams,C,34,PHO,6,6,83,11,32,0.344,0,0,,11,32,0.344,0.344,2,2,1,6,9,15,1,4,3,1,17,24
2003,Walt Williams,SF,32,DAL,15,3,227,32,81,0.395,14,41,0.341,18,40,0.45,0.481,7,7,1,12,31,43,15,5,12,17,28,85
2003,Corliss Williamson,SF,29,DET,15,0,233,37,90,0.411,0,0,,37,90,0.411,0.411,43,58,0.741,13,20,33,15,4,3,20,38,117
2003,Kevin Willis,C,40,SAS,18,0,91,21,40,0.525,1,1,1,20,39,0.513,0.538,3,3,1,19,12,31,2,1,1,8,16,46
2003,Loren Woods,C,24,MIN,2,0,2,1,3,0.333,0,0,,1,3,0.333,0.333,0,0,,1,0,1,0,0,0,0,0,2
2003,Qyntel Woods,PF,21,POR,4,0,18,3,9,0.333,0,1,0,3,8,0.375,0.333,1,2,0.5,1,1,2,0,0,0,1,3,7
2003,Metta World Peace,SF,23,IND,6,6,252,35,90,0.389,12,31,0.387,23,59,0.39,0.456,32,40,0.8,11,24,35,13,15,6,16,25,114
2004,Malik Allen,PF,25,MIA,10,0,138,22,49,0.449,0,0,,22,49,0.449,0.449,6,9,0.667,12,18,30,4,2,9,4,21,50
2004,Rafer Alston,PG,27,MIA,13,0,295,29,91,0.319,12,52,0.231,17,39,0.436,0.385,21,25,0.84,4,25,29,22,5,1,10,22,91
2004,Chris Andersen,PF,25,DEN,5,0,34,3,9,0.333,0,0,,3,9,0.333,0.333,0,0,,6,8,14,2,1,2,2,3,6
2004,Kenny Anderson,PG,33,IND,4,0,19,2,7,0.286,0,0,,2,7,0.286,0.286,0,0,,0,1,1,1,1,0,5,3,4
2004,Shandon Anderson,SG,30,NYK,4,4,117,7,27,0.259,2,7,0.286,5,20,0.25,0.296,1,2,0.5,5,4,9,11,4,1,8,19,17
2004,Carmelo Anthony,SF,19,DEN,4,4,143,21,64,0.328,2,11,0.182,19,53,0.358,0.344,16,20,0.8,7,26,33,11,5,0,17,11,60
2004,Brandon Armstrong,SG,23,NJN,8,0,32,3,12,0.25,0,1,0,3,11,0.273,0.25,0,0,,1,1,2,3,1,0,0,4,6
2004,Darrell Armstrong,PG,35,NOH,7,0,150,8,34,0.235,5,25,0.2,3,9,0.333,0.309,3,3,1,6,9,15,16,6,0,13,10,24
2004,Chucky Atkins,PG,29,BOS,4,4,133,17,39,0.436,3,10,0.3,14,29,0.483,0.474,17,19,0.895,3,11,14,15,3,0,10,2,54
2004,Stacey Augmon,SF,35,NOH,7,0,168,18,48,0.375,0,1,0,18,47,0.383,0.375,16,18,0.889,4,15,19,7,6,1,13,13,52
2004,Vin Baker,PF,32,NYK,4,0,57,8,14,0.571,0,0,,8,14,0.571,0.571,6,9,0.667,6,6,12,1,3,2,2,8,22
2004,Marcus Banks,PG,22,BOS,4,0,60,7,16,0.438,2,5,0.4,5,11,0.455,0.5,4,4,1,1,6,7,7,2,1,3,9,20
2004,Dana Barros,SG,36,BOS,1,0,1,0,1,0,0,0,,0,1,0,0,0,0,,0,0,0,0,0,0,0,0,0
2004,Jon Barry,SG,34,DEN,5,1,100,8,24,0.333,3,9,0.333,5,15,0.333,0.396,2,3,0.667,4,14,18,10,3,0,4,4,21
2004,Shane Battier,SF,25,MEM,4,0,69,6,15,0.4,3,7,0.429,3,8,0.375,0.5,4,6,0.667,6,6,12,1,0,1,4,17,19
2004,Jonathan Bender,SF,23,IND,16,0,200,28,69,0.406,9,25,0.36,19,44,0.432,0.471,12,16,0.75,10,18,28,7,2,14,12,19,77
2004,Mike Bibby,PG,25,SAC,12,12,497,84,196,0.429,24,55,0.436,60,141,0.426,0.49,48,55,0.873,9,41,50,84,23,5,35,40,240
2004,Chauncey Billups,PG,27,DET,23,23,881,110,286,0.385,37,107,0.346,73,179,0.408,0.449,121,136,0.89,14,56,70,136,31,2,60,57,378
2004,Mark Blount,C,28,BOS,4,4,145,17,35,0.486,0,0,,17,35,0.486,0.486,14,19,0.737,10,27,37,4,6,8,9,17,48
2004,Bruce Bowen,SF,32,SAS,10,10,298,23,63,0.365,11,29,0.379,12,34,0.353,0.452,3,13,0.231,6,23,29,10,4,3,4,24,60
2004,Ryan Bowen,PF,28,DEN,4,0,6,1,1,1,0,0,,1,1,1,1,0,0,,0,0,0,0,0,0,0,0,2
2004,Earl Boykins,SG,27,DEN,5,0,121,28,63,0.444,5,14,0.357,23,49,0.469,0.484,6,7,0.857,6,6,12,19,5,1,6,6,67
2004,Shawn Bradley,C,31,DAL,2,0,3,0,0,,0,0,,0,0,,,0,0,,0,0,0,0,0,0,0,1,0
2004,Devin Brown,SG,25,SAS,9,0,130,18,37,0.486,6,10,0.6,12,27,0.444,0.568,10,17,0.588,4,14,18,9,3,1,7,18,52
2004,P.J. Brown,PF,34,NOH,7,7,256,26,71,0.366,0,0,,26,71,0.366,0.366,10,11,0.909,29,39,68,15,3,11,13,16,62
2004,Kobe Bryant,SG,25,LAL,22,22,973,190,460,0.413,24,97,0.247,166,363,0.457,0.439,135,166,0.813,18,86,104,121,42,7,61,59,539
2004,Rodney Buford,SF,26,SAC,5,0,32,5,12,0.417,1,3,0.333,4,9,0.444,0.458,1,2,0.5,0,5,5,3,2,0,0,2,12
2004,Caron Butler,SF,23,MIA,13,13,511,59,153,0.386,2,11,0.182,57,142,0.401,0.392,47,57,0.825,18,92,110,31,28,7,23,45,167
2004,Rasual Butler,SF,24,MIA,10,0,58,9,22,0.409,3,9,0.333,6,13,0.462,0.477,0,0,,0,11,11,2,1,0,1,12,21
2004,Marcus Camby,C,29,DEN,5,5,194,27,55,0.491,1,2,0.5,26,53,0.491,0.5,8,14,0.571,14,43,57,12,4,7,6,21,63
2004,Elden Campbell,C,35,DET,14,0,124,10,35,0.286,0,0,,10,35,0.286,0.286,10,18,0.556,10,15,25,10,6,9,9,28,30
2004,Maurice Carter,SG,27,NOH,1,0,2,0,1,0,0,0,,0,1,0,0,0,0,,0,0,0,0,0,0,0,0,0
2004,Sam Cassell,PG,34,MIN,16,15,497,94,202,0.465,25,60,0.417,69,142,0.486,0.527,52,61,0.852,3,37,40,70,12,3,43,53,265
2004,Kelvin Cato,PF,29,HOU,5,5,148,13,22,0.591,0,0,,13,22,0.591,0.591,3,7,0.429,14,20,34,2,5,4,5,18,29
2004,Doug Christie,SG,33,SAC,12,12,461,56,141,0.397,13,33,0.394,43,108,0.398,0.443,41,48,0.854,17,57,74,47,22,5,22,35,166
2004,Jason Collins,C,25,NJN,11,11,266,14,38,0.368,0,0,,14,38,0.368,0.368,12,16,0.75,18,26,44,17,3,10,15,49,40
2004,Brian Cook,C,23,LAL,13,0,46,5,15,0.333,0,0,,5,15,0.333,0.333,2,2,1,3,9,12,1,1,0,3,7,12
2004,Austin Croshere,PF,28,IND,13,2,214,19,55,0.345,8,24,0.333,11,31,0.355,0.418,17,21,0.81,13,27,40,12,4,3,6,17,63
2004,Marquis Daniels,SG,23,DAL,5,5,184,32,75,0.427,1,7,0.143,31,68,0.456,0.433,14,22,0.636,10,21,31,15,10,3,15,14,79
2004,Baron Davis,PG,24,NOH,7,7,260,43,114,0.377,16,49,0.327,27,65,0.415,0.447,25,33,0.758,6,23,29,49,11,5,19,21,127
2004,Ricky Davis,SF,24,BOS,4,0,123,16,40,0.4,4,10,0.4,12,30,0.4,0.45,11,16,0.688,3,9,12,14,2,0,12,7,47
2004,Tony Delk,SG,30,DAL,1,0,5,0,0,,0,0,,0,0,,,0,0,,0,1,1,2,1,0,0,0,0
2004,Vlade Divac,C,35,SAC,12,12,235,31,71,0.437,0,0,,31,71,0.437,0.437,17,23,0.739,22,37,59,22,4,5,14,31,79
2004,Michael Doleac,C,26,DEN,5,0,49,5,10,0.5,0,0,,5,10,0.5,0.5,0,0,,2,5,7,3,0,0,1,8,10
2004,Tim Duncan,PF,27,SAS,10,10,405,83,159,0.522,0,1,0,83,158,0.525,0.522,55,87,0.632,33,80,113,32,8,20,42,34,221
2004,Francisco Elson,C,27,DEN,4,0,60,7,12,0.583,0,0,,7,12,0.583,0.583,1,2,0.5,1,8,9,2,2,1,3,14,15
2004,Michael Finley,SG,30,DAL,5,5,196,26,68,0.382,7,26,0.269,19,42,0.452,0.434,6,10,0.6,6,10,16,13,4,3,9,8,65
2004,Derek Fisher,SG,29,LAL,22,0,507,60,148,0.405,23,55,0.418,37,93,0.398,0.483,23,35,0.657,10,46,56,49,18,0,19,47,166
2004,Jeff Foster,C,27,IND,16,13,307,25,43,0.581,0,1,0,25,42,0.595,0.581,8,10,0.8,44,61,105,12,13,5,13,37,58
2004,Rick Fox,SF,34,LAL,16,3,145,8,20,0.4,1,7,0.143,7,13,0.538,0.425,1,2,0.5,6,17,23,18,3,2,9,21,18
2004,Steve Francis,PG,26,HOU,5,5,222,30,70,0.429,7,17,0.412,23,53,0.434,0.479,29,40,0.725,6,36,42,38,7,1,21,18,96
2004,Dan Gadzuric,C,25,MIL,1,0,9,2,4,0.5,0,0,,2,4,0.5,0.5,0,1,0,0,1,1,2,1,0,0,1,4
2004,Kevin Garnett,PF,27,MIN,18,18,783,168,372,0.452,5,16,0.313,163,356,0.458,0.458,97,125,0.776,39,224,263,92,24,41,75,57,438
2004,Pau Gasol,PF,23,MEM,4,4,134,28,49,0.571,0,0,,28,49,0.571,0.571,18,20,0.9,4,16,20,10,4,6,5,10,74
2004,Devean George,SF,26,LAL,22,19,470,43,100,0.43,22,59,0.373,21,41,0.512,0.54,13,20,0.65,11,39,50,11,21,8,11,45,121
2004,Manu Ginobili,SG,26,SAS,10,0,280,42,94,0.447,10,35,0.286,32,59,0.542,0.5,36,44,0.818,15,38,53,31,17,1,21,30,130
2004,Brian Grant,C,31,MIA,13,13,399,42,98,0.429,0,1,0,42,97,0.433,0.429,8,14,0.571,45,67,112,10,7,8,18,52,92
2004,Marcus Haislip,PF,23,MIL,1,0,3,1,1,1,0,0,,1,1,1,1,0,0,,1,0,1,0,0,0,0,0,2
2004,Darvin Ham,SF,30,DET,22,0,108,8,16,0.5,0,1,0,8,15,0.533,0.5,0,0,,8,6,14,1,3,4,8,19,16
2004,Richard Hamilton,SG,25,DET,23,23,924,181,405,0.447,15,39,0.385,166,366,0.454,0.465,117,138,0.848,32,74,106,97,27,1,72,72,494
2004,Anfernee Hardaway,SG,32,NYK,4,3,168,23,63,0.365,5,14,0.357,18,49,0.367,0.405,15,18,0.833,4,14,18,23,6,1,10,8,66
2004,Al Harrington,PF,23,IND,16,2,427,60,140,0.429,2,5,0.4,58,135,0.43,0.436,30,55,0.545,33,69,102,12,23,9,28,56,152
2004,Lucious Harris,PG,33,NJN,11,0,182,19,49,0.388,3,12,0.25,16,37,0.432,0.418,14,18,0.778,10,12,22,10,7,1,5,16,55
2004,Jason Hart,PG,25,SAS,7,0,62,11,20,0.55,0,0,,11,20,0.55,0.55,0,0,,0,3,3,1,5,0,1,5,22
2004,Udonis Haslem,PF,23,MIA,13,0,199,13,33,0.394,0,0,,13,33,0.394,0.394,21,31,0.677,18,26,44,3,5,3,3,22,47
2004,Trenton Hassell,SG,24,MIN,18,18,472,62,119,0.521,1,2,0.5,61,117,0.521,0.525,13,16,0.813,21,23,44,27,10,7,16,42,138
2004,Nene Hilario,PF,21,DEN,5,5,132,16,36,0.444,0,0,,16,36,0.444,0.444,7,13,0.538,12,13,25,15,5,3,9,22,39
2004,Fred Hoiberg,SG,31,MIN,18,0,438,39,86,0.453,22,48,0.458,17,38,0.447,0.581,15,16,0.938,9,57,66,23,16,0,8,29,115
2004,Robert Horry,PF,33,SAS,10,0,211,20,43,0.465,8,22,0.364,12,21,0.571,0.558,13,14,0.929,25,38,63,9,8,2,10,31,61
2004,Josh Howard,SF,23,DAL,5,0,86,8,36,0.222,1,5,0.2,7,31,0.226,0.236,10,11,0.909,17,15,32,4,6,6,7,12,27
2004,Ryan Humphrey,PF,24,MEM,3,0,5,1,1,1,0,0,,1,1,1,1,0,0,,1,1,2,0,0,0,0,0,2
2004,Brandon Hunter,PF,23,BOS,3,0,10,1,1,1,0,0,,1,1,1,1,0,0,,2,1,3,1,0,1,1,2,2
2004,Lindsey Hunter,SG,33,DET,23,0,273,19,65,0.292,7,30,0.233,12,35,0.343,0.346,11,12,0.917,5,28,33,21,18,4,13,42,56
2004,Jim Jackson,SF,33,HOU,5,5,221,29,73,0.397,8,29,0.276,21,44,0.477,0.452,8,12,0.667,3,49,52,10,5,1,9,9,74
2004,Mark Jackson,PG,38,HOU,5,0,38,1,6,0.167,0,3,0,1,3,0.333,0.167,0,0,,0,3,3,5,2,0,2,1,2
2004,Mike James,PG,28,DET,22,0,195,21,53,0.396,6,14,0.429,15,39,0.385,0.453,9,16,0.563,7,19,26,24,5,0,15,23,57
2004,Antawn Jamison,SF,27,DAL,5,0,109,26,57,0.456,2,8,0.25,24,49,0.49,0.474,11,15,0.733,15,10,25,2,5,2,5,15,65
2004,Richard Jefferson,SF,23,NJN,11,11,460,66,158,0.418,9,33,0.273,57,125,0.456,0.446,77,108,0.713,14,55,69,42,14,8,43,35,218
2004,Anthony Johnson,PG,29,IND,16,0,332,25,69,0.362,6,20,0.3,19,49,0.388,0.406,17,22,0.773,7,27,34,34,13,4,11,34,73
2004,DerMarr Johnson,SF,23,NYK,3,0,17,0,5,0,0,3,0,0,2,0,0,0,0,,0,2,2,2,0,1,0,2,0
2004,Ervin Johnson,C,36,MIN,18,16,356,19,38,0.5,0,0,,19,38,0.5,0.5,10,16,0.625,27,57,84,13,11,10,6,56,48
2004,Damon Jones,PG,27,MIL,5,5,144,18,34,0.529,10,21,0.476,8,13,0.615,0.676,4,6,0.667,2,18,20,37,5,0,9,14,50
2004,Eddie Jones,SG,32,MIA,13,13,478,56,153,0.366,20,67,0.299,36,86,0.419,0.431,40,50,0.8,3,44,47,29,18,11,19,37,172
2004,Fred Jones,SG,24,IND,14,0,263,25,51,0.49,11,22,0.5,14,29,0.483,0.598,5,7,0.714,3,30,33,16,7,7,9,31,66
2004,Jumaine Jones,SG,24,BOS,2,0,28,2,6,0.333,0,2,0,2,4,0.5,0.333,0,0,,1,4,5,2,0,0,0,4,4
2004,Jason Kidd*,PG,30,NJN,11,11,474,43,129,0.333,10,48,0.208,33,81,0.407,0.372,43,53,0.811,16,57,73,99,25,6,43,15,139
2004,Kerry Kittles,SG,29,NJN,11,11,415,60,134,0.448,17,52,0.327,43,82,0.524,0.511,21,34,0.618,10,37,47,23,22,10,11,28,158
2004,Brevin Knight,PG,28,MIL,5,0,101,6,23,0.261,0,0,,6,23,0.261,0.261,9,11,0.818,3,8,11,17,14,1,7,12,21
2004,Toni Kukoc,PF,35,MIL,5,0,105,17,34,0.5,4,12,0.333,13,22,0.591,0.559,4,8,0.5,4,10,14,4,3,2,6,11,42
2004,Voshon Lenard,SG,30,DEN,5,5,161,32,75,0.427,11,24,0.458,21,51,0.412,0.5,10,14,0.714,4,9,13,12,4,0,9,13,85
2004,George Lynch,SF,33,NOH,7,7,147,25,57,0.439,3,12,0.25,22,45,0.489,0.465,5,8,0.625,13,24,37,12,3,3,7,15,58
2004,Mark Madsen,C,28,MIN,17,0,222,17,32,0.531,0,0,,17,32,0.531,0.531,13,29,0.448,28,30,58,2,5,4,7,43,47
2004,Jamaal Magloire,C,25,NOH,7,7,239,28,67,0.418,0,1,0,28,66,0.424,0.418,21,28,0.75,16,48,64,5,3,7,11,22,77
2004,Karl Malone*,PF,40,LAL,21,21,798,98,218,0.45,0,1,0,98,217,0.452,0.45,46,73,0.63,37,148,185,72,24,2,47,65,242
2004,Stephon Marbury,PG,26,NYK,4,4,174,31,83,0.373,6,20,0.3,25,63,0.397,0.41,17,25,0.68,5,12,17,26,7,0,14,9,85
2004,Darrick Martin,PG,32,MIN,16,3,182,14,51,0.275,6,20,0.3,8,31,0.258,0.333,16,20,0.8,5,9,14,23,4,0,8,17,50
2004,Kenyon Martin,PF,26,NJN,11,11,409,81,152,0.533,0,4,0,81,148,0.547,0.533,48,64,0.75,25,96,121,12,13,14,32,50,210
2004,Desmond Mason,SF,26,MIL,5,5,198,25,74,0.338,0,2,0,25,72,0.347,0.338,22,26,0.846,4,20,24,12,4,2,12,16,72
2004,Walter McCarty,PF,29,BOS,4,4,127,11,23,0.478,6,15,0.4,5,8,0.625,0.609,0,0,,3,18,21,8,2,2,4,7,28
2004,Stanislav Medvedenko,PF,24,LAL,21,1,237,33,75,0.44,0,0,,33,75,0.44,0.44,17,21,0.81,23,30,53,10,4,4,5,50,83
2004,Chris Mihm,C,24,BOS,4,0,65,7,22,0.318,0,0,,7,22,0.318,0.318,6,10,0.6,8,10,18,0,4,4,3,12,20
2004,Darko Milicic,C,18,DET,8,0,14,0,4,0,0,0,,0,4,0,0,1,4,0.25,1,2,3,1,1,0,3,1,1
2004,Andre Miller,PG,27,DEN,5,5,174,34,72,0.472,0,2,0,34,70,0.486,0.472,9,11,0.818,15,8,23,16,8,0,10,16,77
2004,Brad Miller,PF,27,SAC,12,0,366,48,91,0.527,1,7,0.143,47,84,0.56,0.533,29,48,0.604,30,74,104,38,9,11,20,46,126
2004,Mike Miller,SF,23,MEM,4,4,98,12,34,0.353,5,13,0.385,7,21,0.333,0.426,1,3,0.333,0,12,12,3,5,0,5,4,30
2004,Oliver Miller,C,33,MIN,8,0,31,1,4,0.25,0,0,,1,4,0.25,0.25,1,2,0.5,0,5,5,1,0,3,3,13,3
2004,Reggie Miller*,SG,38,IND,16,16,455,45,112,0.402,24,64,0.375,21,48,0.438,0.509,47,51,0.922,3,34,37,45,18,3,28,23,161
2004,Yao Ming*,C,23,HOU,5,5,185,31,68,0.456,0,0,,31,68,0.456,0.456,13,17,0.765,11,26,37,9,2,7,13,20,75
2004,Cuttino Mobley,SG,28,HOU,5,5,210,29,75,0.387,6,21,0.286,23,54,0.426,0.427,8,10,0.8,5,19,24,14,3,3,18,14,72
2004,Nazr Mohammed,C,26,NYK,4,4,97,15,30,0.5,0,0,,15,30,0.5,0.5,11,16,0.688,10,13,23,1,6,3,7,18,41
2004,Dikembe Mutombo*,C,37,NYK,3,0,38,2,6,0.333,0,0,,2,6,0.333,0.333,3,3,1,4,6,10,0,1,4,3,6,7
2004,Bostjan Nachbar,SF,23,HOU,5,0,41,4,9,0.444,1,3,0.333,3,6,0.5,0.5,5,5,1,1,5,6,2,1,0,2,9,14
2004,Eduardo Najera,SF,27,DAL,5,0,57,5,11,0.455,0,0,,5,11,0.455,0.455,2,2,1,10,7,17,3,3,2,2,12,12
2004,Steve Nash*,PG,29,DAL,5,5,197,27,70,0.386,6,16,0.375,21,54,0.389,0.429,8,9,0.889,6,20,26,45,4,0,12,14,68
2004,Rasho Nesterovic,C,27,SAS,10,10,261,29,67,0.433,0,1,0,29,66,0.439,0.433,1,6,0.167,21,34,55,10,3,11,8,38,59
2004,Dirk Nowitzki,C,25,DAL,5,5,212,45,100,0.45,7,15,0.467,38,85,0.447,0.485,36,42,0.857,13,46,59,7,7,13,6,16,133
2004,Jermaine O'Neal,PF,25,IND,16,16,604,115,272,0.423,0,4,0,115,268,0.429,0.423,77,110,0.7,29,117,146,19,8,36,29,53,307
2004,Shaquille O'Neal*,C,31,LAL,22,22,917,182,307,0.593,0,0,,182,307,0.593,0.593,109,254,0.429,91,200,291,55,7,61,55,90,473
2004,Lamar Odom,PF,24,MIA,13,13,512,81,182,0.445,8,26,0.308,73,156,0.468,0.467,49,72,0.681,32,76,108,37,15,10,42,58,219
2004,Mehmet Okur,PF,24,DET,22,0,252,31,66,0.47,2,5,0.4,29,61,0.475,0.485,18,26,0.692,16,45,61,8,5,9,15,20,82
2004,Michael Olowokandi,C,28,MIN,15,2,224,12,37,0.324,0,1,0,12,36,0.333,0.324,7,8,0.875,16,36,52,2,2,11,17,50,31
2004,Bo Outlaw,PF,32,MEM,4,0,61,0,7,0,0,0,,0,7,0,0,2,4,0.5,1,3,4,6,2,2,3,9,2
2004,Scott Padgett,PF,27,HOU,4,0,14,2,5,0.4,1,3,0.333,1,2,0.5,0.5,0,0,,1,2,3,0,1,1,1,1,5
2004,Tony Parker,PG,21,SAS,10,10,386,72,168,0.429,17,43,0.395,55,125,0.44,0.479,23,35,0.657,5,16,21,70,13,1,31,15,184
2004,Gary Payton*,PG,35,LAL,22,22,772,68,186,0.366,14,56,0.25,54,130,0.415,0.403,21,28,0.75,19,53,72,116,23,4,28,60,171
2004,Anthony Peeler,SG,34,SAC,11,0,236,19,63,0.302,7,26,0.269,12,37,0.324,0.357,5,6,0.833,7,28,35,15,14,2,14,19,50
2004,Eric Piatkowski,SF,33,HOU,1,0,4,0,1,0,0,0,,0,1,0,0,0,0,,0,1,1,0,0,0,0,1,0
2004,Paul Pierce,SG,26,BOS,4,4,162,26,76,0.342,5,17,0.294,21,59,0.356,0.375,26,31,0.839,6,29,35,10,5,4,25,12,83
2004,Zoran Planinic,SG,21,NJN,6,0,15,0,2,0,0,1,0,0,1,0,0,1,2,0.5,0,1,1,2,0,0,2,2,1
2004,Scot Pollard,C,28,IND,3,0,13,0,2,0,0,0,,0,2,0,0,2,4,0.5,1,3,4,0,1,0,0,2,2
2004,James Posey,SG,27,MEM,4,4,130,15,37,0.405,1,6,0.167,14,31,0.452,0.419,19,21,0.905,8,14,22,4,9,2,6,13,50
2004,Tayshaun Prince,SF,23,DET,23,23,795,87,212,0.41,13,49,0.265,74,163,0.454,0.441,41,55,0.745,41,96,137,53,25,31,19,61,228
2004,Michael Redd,SG,24,MIL,5,5,192,34,83,0.41,6,20,0.3,28,63,0.444,0.446,16,21,0.762,6,19,25,13,0,0,19,16,90
2004,Rodney Rogers,PF,32,NJN,11,0,228,23,72,0.319,5,22,0.227,18,50,0.36,0.354,16,20,0.8,9,46,55,12,6,3,17,31,67
2004,Malik Rose,PF,29,SAS,7,0,58,4,16,0.25,0,2,0,4,14,0.286,0.25,2,4,0.5,12,5,17,6,4,2,8,6,10
2004,Kareem Rush,SG,23,LAL,22,0,315,30,78,0.385,20,50,0.4,10,28,0.357,0.513,2,3,0.667,0,16,16,17,10,3,14,33,82
2004,Bryon Russell,SF,33,LAL,6,0,16,0,3,0,0,2,0,0,1,0,0,0,0,,1,0,1,2,1,0,0,2,0
2004,Daniel Santiago,C,27,MIL,1,0,1,0,0,,0,0,,0,0,,,0,0,,0,0,0,0,0,0,0,1,0
2004,Brian Scalabrine,PF,25,NJN,9,0,73,11,17,0.647,5,6,0.833,6,11,0.545,0.794,3,6,0.5,7,5,12,1,3,0,4,15,30
2004,Brian Skinner,C,27,MIL,5,3,94,11,21,0.524,0,0,,11,21,0.524,0.524,5,12,0.417,8,14,22,0,1,3,7,8,27
2004,Tamar Slay,SG,23,NJN,6,0,12,1,5,0.2,0,1,0,1,4,0.25,0.2,2,2,1,0,2,2,0,1,0,0,0,4
2004,Jabari Smith,C,26,SAC,4,0,10,1,2,0.5,0,0,,1,2,0.5,0.5,3,4,0.75,1,2,3,0,0,1,0,2,5
2004,Joe Smith,PF,28,MIL,5,5,175,27,55,0.491,0,1,0,27,54,0.5,0.491,12,13,0.923,23,27,50,2,4,10,6,15,66
2004,Steve Smith,SG,34,NOH,5,0,46,12,26,0.462,6,11,0.545,6,15,0.4,0.577,2,3,0.667,2,6,8,1,0,0,3,5,32
2004,Darius Songaila,PF,25,SAC,7,0,85,10,16,0.625,0,0,,10,16,0.625,0.625,6,6,1,6,7,13,2,0,1,5,14,26
2004,Latrell Sprewell,SF,33,MIN,18,18,771,130,309,0.421,37,96,0.385,93,213,0.437,0.481,60,77,0.779,11,68,79,72,29,12,47,35,357
2004,Michael Stewart,C,28,BOS,1,0,2,0,0,,0,0,,0,0,,,0,0,,0,0,0,0,0,0,0,2,0
2004,Peja Stojakovic,SF,26,SAC,12,12,517,76,198,0.384,23,73,0.315,53,125,0.424,0.442,35,39,0.897,15,69,84,18,22,3,14,26,210
2004,Erick Strickland,PG,30,MIL,3,0,41,5,12,0.417,0,5,0,5,7,0.714,0.417,4,4,1,0,5,5,9,2,0,3,3,14
2004,Mike Sweetney,PF,21,NYK,4,0,57,6,11,0.545,0,0,,6,11,0.545,0.545,4,6,0.667,4,6,10,0,0,1,0,7,16
2004,Stromile Swift,PF,24,MEM,4,0,74,9,26,0.346,0,0,,9,26,0.346,0.346,6,8,0.75,6,13,19,3,3,6,3,6,24
2004,Wally Szczerbiak,SF,26,MIN,12,0,298,47,112,0.42,10,29,0.345,37,83,0.446,0.464,38,41,0.927,9,30,39,20,6,2,24,31,142
2004,Maurice Taylor,PF,27,HOU,5,0,115,18,38,0.474,0,0,,18,38,0.474,0.474,13,17,0.765,5,11,16,5,0,1,7,20,49
2004,Kurt Thomas,PF,31,NYK,4,4,139,21,49,0.429,0,0,,21,49,0.429,0.429,9,12,0.75,9,37,46,6,7,3,10,17,51
2004,Tim Thomas,SF,26,NYK,1,1,22,4,10,0.4,0,1,0,4,9,0.444,0.4,4,5,0.8,1,4,5,3,0,0,2,5,12
2004,Jamaal Tinsley,PG,25,IND,16,16,422,49,123,0.398,16,54,0.296,33,69,0.478,0.463,15,16,0.938,6,40,46,80,28,3,31,56,129
2004,Robert Traylor,C,26,NOH,4,0,40,4,9,0.444,0,0,,4,9,0.444,0.444,2,3,0.667,1,9,10,1,3,1,2,8,10
2004,Gary Trent,C,29,MIN,13,0,71,8,25,0.32,0,2,0,8,23,0.348,0.32,5,8,0.625,6,6,12,2,0,0,3,11,21
2004,Jake Tsakalidis,C,24,MEM,1,0,3,0,0,,0,0,,0,0,,,2,2,1,0,0,0,0,0,0,3,0,2
2004,Hedo Turkoglu,SF,24,SAS,10,10,271,26,81,0.321,14,42,0.333,12,39,0.308,0.407,11,18,0.611,5,40,45,15,9,1,16,20,77
2004,Keith Van Horn,SF,28,MIL,5,2,137,16,48,0.333,4,11,0.364,12,37,0.324,0.375,4,6,0.667,5,18,23,7,7,3,10,15,40
2004,Dwyane Wade,PG,22,MIA,13,13,510,86,189,0.455,3,8,0.375,83,181,0.459,0.463,59,75,0.787,16,36,52,73,17,4,54,45,234
2004,Antoine Walker,PF,27,DAL,5,5,140,22,61,0.361,1,10,0.1,21,51,0.412,0.369,4,7,0.571,23,27,50,12,6,3,9,13,49
2004,Samaki Walker,PF,27,MIA,4,0,11,0,2,0,0,0,,0,2,0,0,0,0,,0,1,1,0,0,0,0,2,0
2004,Ben Wallace,C,29,DET,23,23,924,93,205,0.454,0,3,0,93,202,0.46,0.454,50,117,0.427,95,233,328,44,44,56,37,58,236
2004,Gerald Wallace,SF,21,SAC,3,0,20,3,6,0.5,0,0,,3,6,0.5,0.5,1,2,0.5,0,2,2,1,1,1,3,4,7
2004,Rasheed Wallace,PF,29,DET,23,23,803,118,286,0.413,17,70,0.243,101,216,0.468,0.442,46,60,0.767,47,132,179,37,13,45,43,78,299
2004,Luke Walton,PF,23,LAL,17,0,134,10,29,0.345,5,13,0.385,5,16,0.313,0.431,7,10,0.7,5,17,22,26,7,2,14,24,32
2004,Charlie Ward,PG,33,SAS,5,0,13,4,6,0.667,3,3,1,1,3,0.333,0.917,0,0,,0,0,0,1,2,0,2,2,11
2004,Earl Watson,PG,24,MEM,4,0,62,8,15,0.533,0,3,0,8,12,0.667,0.533,3,3,1,4,5,9,7,5,0,6,8,19
2004,Clarence Weatherspoon,PF,33,HOU,2,0,22,2,5,0.4,0,0,,2,5,0.4,0.4,3,6,0.5,2,2,4,0,0,0,0,3,7
2004,Chris Webber,PF,30,SAC,12,12,446,90,199,0.452,1,4,0.25,89,195,0.456,0.455,40,65,0.615,24,75,99,44,16,10,38,34,221
2004,Bonzi Wells,SG,27,MEM,4,0,94,19,37,0.514,0,1,0,19,36,0.528,0.514,9,14,0.643,2,10,12,4,4,1,9,8,47
2004,Jiri Welsch,SG,24,BOS,4,4,104,11,23,0.478,1,4,0.25,10,19,0.526,0.5,9,9,1,0,12,12,9,2,0,8,7,32
2004,David Wesley,SG,33,NOH,7,7,243,24,74,0.324,11,30,0.367,13,44,0.295,0.399,15,21,0.714,1,15,16,17,5,0,16,21,74
2004,David West,PF,23,NOH,7,0,111,15,28,0.536,0,0,,15,28,0.536,0.536,11,13,0.846,8,22,30,8,2,4,7,10,41
2004,Rodney White,SF,23,DEN,4,0,26,4,15,0.267,0,3,0,4,12,0.333,0.267,0,0,,1,4,5,0,2,0,2,3,8
2004,Mike Wilks,PG,24,HOU,2,0,5,0,0,,0,0,,0,0,,,0,0,,0,0,0,1,0,0,1,0,0
2004,Aaron Williams,C,32,NJN,11,0,149,18,33,0.545,0,0,,18,33,0.545,0.545,6,10,0.6,7,15,22,4,0,7,15,41,42
2004,Frank Williams,PG,23,NYK,4,0,74,6,22,0.273,4,13,0.308,2,9,0.222,0.364,3,5,0.6,1,1,2,5,3,0,4,13,19
2004,Jason Williams,PG,28,MEM,4,4,130,15,46,0.326,6,21,0.286,9,25,0.36,0.391,7,7,1,1,8,9,18,2,0,7,10,43
2004,Scott Williams,C,35,DAL,3,0,11,0,4,0,0,0,,0,4,0,0,0,0,,2,2,4,0,0,1,0,3,0
2004,Shammond Williams,PG,28,NOH,3,0,18,2,5,0.4,0,1,0,2,4,0.5,0.4,3,4,0.75,0,0,0,4,1,0,4,5,7
2004,Corliss Williamson,PF,30,DET,22,0,327,44,121,0.364,0,1,0,44,120,0.367,0.364,38,47,0.809,20,29,49,15,6,3,24,59,126
2004,Kevin Willis,C,41,SAS,7,0,25,3,8,0.375,0,1,0,3,7,0.429,0.375,0,1,0,0,6,6,0,1,0,0,5,6
2004,Loren Woods,C,25,MIA,1,0,2,0,0,,0,0,,0,0,,,0,0,,0,0,0,0,0,0,0,0,0
2004,Metta World Peace,SF,24,IND,15,15,584,98,259,0.378,19,66,0.288,79,193,0.409,0.415,61,85,0.718,24,74,98,48,21,16,37,45,276
2004,Lorenzen Wright,C,28,MEM,4,4,100,10,23,0.435,0,0,,10,23,0.435,0.435,2,6,0.333,5,12,17,2,4,2,5,15,22
2004,Wang Zhizhi,C,26,MIA,3,0,7,0,0,,0,0,,0,0,,,0,0,,0,0,0,1,0,0,1,1,0
2005,Ray Allen*,SG,29,SEA,11,11,436,102,215,0.474,31,82,0.378,71,133,0.534,0.547,56,63,0.889,12,35,47,43,14,4,34,22,291
2005,Tony Allen,SG,23,BOS,7,3,90,8,18,0.444,0,0,,8,18,0.444,0.444,3,7,0.429,4,8,12,2,3,2,5,17,19
2005,Shandon Anderson,SF,31,MIA,8,0,97,3,12,0.25,0,1,0,3,11,0.273,0.25,2,2,1,3,16,19,8,5,0,6,10,8
2005,Carmelo Anthony,SF,20,DEN,5,5,180,35,83,0.422,0,1,0,35,82,0.427,0.422,26,32,0.813,14,13,27,10,3,1,13,20,96
2005,Gilbert Arenas,PG,23,WAS,10,10,450,73,194,0.376,18,77,0.234,55,117,0.47,0.423,72,94,0.766,8,44,52,62,21,6,39,34,236
2005,Darrell Armstrong,PG,36,DAL,9,0,66,8,16,0.5,2,8,0.25,6,8,0.75,0.563,0,0,,3,1,4,9,3,2,2,9,18
2005,Carlos Arroyo,PG,25,DET,19,0,150,16,45,0.356,0,1,0,16,44,0.364,0.356,8,12,0.667,1,9,10,39,4,2,10,19,40
2005,Marcus Banks,PG,23,BOS,7,0,106,13,29,0.448,3,6,0.5,10,23,0.435,0.5,3,6,0.5,1,10,11,7,4,0,6,16,32
2005,Leandro Barbosa,PG,22,PHO,12,0,116,12,35,0.343,4,10,0.4,8,25,0.32,0.4,2,4,0.5,5,12,17,12,3,0,5,8,30
2005,Brent Barry,SG,33,SAS,23,8,555,48,105,0.457,28,66,0.424,20,39,0.513,0.59,17,21,0.81,13,43,56,44,15,4,27,44,141
2005,Jon Barry,SG,35,HOU,7,0,183,21,48,0.438,11,23,0.478,10,25,0.4,0.552,7,8,0.875,1,28,29,9,5,0,6,13,60
2005,Shane Battier,SG,26,MEM,4,4,119,13,31,0.419,1,7,0.143,12,24,0.5,0.435,2,5,0.4,10,17,27,6,2,4,4,14,29
2005,Travis Best,PG,32,NJN,4,0,82,9,22,0.409,1,9,0.111,8,13,0.615,0.432,8,9,0.889,2,4,6,9,1,0,3,9,27
2005,Mike Bibby,PG,26,SAC,5,5,200,36,92,0.391,5,23,0.217,31,69,0.449,0.418,21,27,0.778,5,17,22,33,7,2,13,11,98
2005,Chauncey Billups,PG,28,DET,25,25,985,145,339,0.428,44,126,0.349,101,213,0.474,0.493,133,149,0.893,23,85,108,162,25,5,49,71,467
2005,Steve Blake,PG,24,WAS,4,0,17,1,4,0.25,0,1,0,1,3,0.333,0.25,0,0,,0,3,3,2,0,0,1,3,2
2005,Mark Blount,C,29,BOS,4,0,43,4,14,0.286,0,0,,4,14,0.286,0.286,0,2,0,3,3,6,1,0,0,5,6,8
2005,Bruce Bowen,SF,33,SAS,23,23,814,46,128,0.359,29,67,0.433,17,61,0.279,0.473,11,17,0.647,9,57,66,36,11,13,15,77,132
2005,Ryan Bowen,SF,29,HOU,7,3,125,8,25,0.32,0,0,,8,25,0.32,0.32,2,3,0.667,7,7,14,6,6,0,6,23,18
2005,Earl Boykins,PG,28,DEN,5,1,152,27,68,0.397,0,7,0,27,61,0.443,0.397,17,19,0.895,2,3,5,19,4,1,9,13,71
2005,Shawn Bradley,C,32,DAL,7,0,27,4,6,0.667,0,0,,4,6,0.667,0.667,1,2,0.5,4,2,6,0,0,2,0,7,9
2005,Devin Brown,SG,26,SAS,12,0,60,7,20,0.35,3,7,0.429,4,13,0.308,0.425,4,7,0.571,1,6,7,3,1,0,1,3,21
2005,Kwame Brown,PF,22,WAS,3,0,60,5,13,0.385,0,0,,5,13,0.385,0.385,5,9,0.556,4,11,15,3,0,2,2,5,15
2005,Greg Buckner,SG,28,DEN,5,2,100,4,18,0.222,2,9,0.222,2,9,0.222,0.278,0,0,,1,15,16,5,2,1,3,14,10
2005,Rodney Buford,SF,27,NJN,3,0,4,0,0,,0,0,,0,0,,,0,0,,0,0,0,0,0,0,0,0,0
2005,Antonio Burks,PG,24,MEM,1,0,3,0,0,,0,0,,0,0,,,0,0,,0,0,0,1,0,0,0,0,0
2005,Rasual Butler,SF,25,MIA,12,1,182,22,59,0.373,11,30,0.367,11,29,0.379,0.466,1,3,0.333,1,17,18,7,1,1,2,21,56
2005,Marcus Camby,C,30,DEN,5,5,184,17,41,0.415,0,0,,17,41,0.415,0.415,17,27,0.63,4,52,56,9,3,16,11,18,51
2005,Elden Campbell,C,36,DET,10,0,57,4,13,0.308,0,0,,4,13,0.308,0.308,4,8,0.5,3,15,18,5,2,0,4,13,12
2005,Brian Cardinal,PF,27,MEM,4,0,78,9,23,0.391,0,4,0,9,19,0.474,0.391,8,11,0.727,2,10,12,2,3,0,1,11,26
2005,Vince Carter,SF,28,NJN,4,4,179,35,96,0.365,6,19,0.316,29,77,0.377,0.396,31,36,0.861,9,25,34,23,9,0,15,17,107
2005,Tyson Chandler,C,22,CHI,6,0,172,19,40,0.475,0,0,,19,40,0.475,0.475,32,46,0.696,29,29,58,8,1,13,8,27,70
2005,Jason Collins,C,26,NJN,4,4,128,4,17,0.235,0,0,,4,17,0.235,0.235,3,8,0.375,9,17,26,1,2,0,5,19,11
2005,Nick Collison,C,24,SEA,11,0,218,37,61,0.607,1,1,1,36,60,0.6,0.615,17,27,0.63,22,33,55,5,3,5,6,40,92
2005,Austin Croshere,PF,29,IND,10,0,88,4,10,0.4,2,4,0.5,2,6,0.333,0.5,15,18,0.833,7,10,17,0,4,1,6,10,25
2005,Samuel Dalembert,C,23,PHI,5,5,192,26,47,0.553,0,0,,26,47,0.553,0.553,6,15,0.4,18,46,64,2,2,7,9,19,58
2005,Erick Dampier,C,29,DAL,13,13,308,40,67,0.597,0,1,0,40,66,0.606,0.597,11,28,0.393,51,46,97,7,7,18,12,54,91
2005,Antonio Daniels,PG,29,SEA,11,3,331,44,94,0.468,4,14,0.286,40,80,0.5,0.489,60,70,0.857,4,27,31,49,11,0,11,13,152
2005,Marquis Daniels,SG,24,DAL,11,0,165,26,60,0.433,1,6,0.167,25,54,0.463,0.442,19,27,0.704,15,19,34,14,6,3,13,15,72
2005,Antonio Davis,PF,36,CHI,6,6,175,20,46,0.435,0,0,,20,46,0.435,0.435,17,23,0.739,17,24,41,11,4,4,9,25,57
2005,Dale Davis,C,35,IND,13,13,311,26,58,0.448,0,0,,26,58,0.448,0.448,17,25,0.68,37,44,81,5,9,6,9,35,69
2005,Josh Davis,PF,24,PHI,2,0,4,0,1,0,0,1,0,0,0,,0,0,0,,0,1,1,0,0,0,0,1,0
2005,Ricky Davis,SG,25,BOS,7,2,240,32,74,0.432,3,9,0.333,29,65,0.446,0.453,20,26,0.769,5,20,25,14,9,2,21,23,87
2005,Juan Dixon,SG,26,WAS,10,0,219,41,101,0.406,11,34,0.324,30,67,0.448,0.46,21,25,0.84,3,23,26,13,7,0,12,19,114
2005,Michael Doleac,C,27,MIA,9,0,65,7,16,0.438,0,0,,7,16,0.438,0.438,2,2,1,2,12,14,0,1,1,3,13,16
2005,Keyon Dooling,PG,24,MIA,15,0,264,43,87,0.494,7,19,0.368,36,68,0.529,0.534,17,21,0.81,1,15,16,25,6,1,14,34,110
2005,Chris Duhon,PG,22,CHI,6,5,159,11,37,0.297,6,22,0.273,5,15,0.333,0.378,9,11,0.818,6,20,26,21,2,0,12,6,37
2005,Tim Duncan,PF,28,SAS,23,23,869,197,425,0.464,1,5,0.2,196,420,0.467,0.465,147,205,0.717,87,199,286,63,8,52,62,66,542
2005,Ronald Dupree,SF,24,DET,14,0,38,2,7,0.286,0,0,,2,7,0.286,0.286,0,0,,2,4,6,0,0,0,1,6,4
2005,Francisco Elson,C,28,DEN,1,0,6,0,1,0,0,0,,0,1,0,0,0,0,,0,3,3,0,0,0,0,0,0
2005,Maurice Evans,SG,26,SAC,3,0,56,6,10,0.6,2,4,0.5,4,6,0.667,0.7,4,5,0.8,2,5,7,3,2,0,0,6,18
2005,Reggie Evans,PF,24,SEA,11,11,208,15,37,0.405,0,0,,15,37,0.405,0.405,11,21,0.524,27,54,81,5,5,3,11,32,41
2005,Michael Finley,SG,31,DAL,13,13,491,65,153,0.425,24,61,0.393,41,92,0.446,0.503,16,18,0.889,13,43,56,28,17,0,13,32,170
2005,Danny Fortson,C,28,SEA,11,0,105,12,21,0.571,0,0,,12,21,0.571,0.571,12,15,0.8,5,21,26,0,3,1,13,42,36
2005,Jeff Foster,C,28,IND,13,0,245,31,52,0.596,0,0,,31,52,0.596,0.596,15,21,0.714,46,50,96,5,6,12,8,27,77
2005,Lawrence Funderburke,PF,34,CHI,5,0,28,1,2,0.5,0,0,,1,2,0.5,0.5,1,2,0.5,0,3,3,1,0,0,0,8,3
2005,Pau Gasol,PF,24,MEM,4,4,133,39,80,0.488,1,1,1,38,79,0.481,0.494,6,12,0.5,15,15,30,10,2,7,7,12,85
2005,Eddie Gill,PG,26,IND,7,0,45,5,16,0.313,1,6,0.167,4,10,0.4,0.344,13,15,0.867,0,4,4,5,1,0,3,0,24
2005,Manu Ginobili,SG,27,SAS,23,15,772,145,286,0.507,42,96,0.438,103,190,0.542,0.58,147,185,0.795,19,114,133,97,28,6,66,69,479
2005,Ben Gordon,SG,21,CHI,6,1,153,30,74,0.405,7,22,0.318,23,52,0.442,0.453,20,25,0.8,6,10,16,15,5,2,13,18,87
2005,Willie Green,SG,23,PHI,5,0,63,8,18,0.444,2,9,0.222,6,9,0.667,0.5,9,10,0.9,3,6,9,3,1,0,2,5,27
2005,Adrian Griffin,SF,30,CHI,5,0,86,15,29,0.517,0,0,,15,29,0.517,0.517,4,5,0.8,5,15,20,9,5,0,3,14,34
2005,Darvin Ham,SF,31,DET,14,0,24,1,3,0.333,0,0,,1,3,0.333,0.333,2,2,1,3,0,3,0,0,0,0,2,4
2005,Richard Hamilton,SG,26,DET,25,25,1079,198,437,0.453,10,34,0.294,188,403,0.467,0.465,95,119,0.798,30,78,108,107,21,3,78,79,501
2005,Othella Harrington,PF,31,CHI,6,6,103,21,42,0.5,0,0,,21,42,0.5,0.5,6,11,0.545,6,9,15,3,1,0,8,19,48
2005,Devin Harris,PG,21,DAL,9,0,80,7,16,0.438,2,6,0.333,5,10,0.5,0.5,6,9,0.667,0,11,11,11,4,1,10,5,22
2005,Udonis Haslem,PF,24,MIA,15,15,543,52,106,0.491,0,0,,52,106,0.491,0.491,34,46,0.739,38,112,150,15,8,6,18,48,138
2005,Brendan Haywood,C,25,WAS,10,10,296,39,72,0.542,0,0,,39,72,0.542,0.542,28,44,0.636,35,41,76,10,14,20,10,40,106
2005,Alan Henderson,PF,32,DAL,9,0,92,8,14,0.571,0,0,,8,14,0.571,0.571,2,2,1,11,6,17,0,2,2,2,15,18
2005,Nene Hilario,C,22,DEN,5,0,101,9,21,0.429,0,0,,9,21,0.429,0.429,15,23,0.652,9,16,25,2,2,2,5,16,33
2005,Kirk Hinrich,PG,24,CHI,6,6,213,45,100,0.45,17,33,0.515,28,67,0.418,0.535,20,29,0.69,4,18,22,35,12,4,14,18,127
2005,Robert Horry,PF,34,SAS,23,0,618,73,163,0.448,38,85,0.447,35,78,0.449,0.564,30,41,0.732,46,79,125,47,21,20,20,53,214
2005,Eddie House,PG,26,SAC,3,0,23,3,8,0.375,1,1,1,2,7,0.286,0.438,2,2,1,1,1,2,4,0,0,1,2,9
2005,Josh Howard,SF,24,DAL,13,13,428,78,155,0.503,4,16,0.25,74,139,0.532,0.516,41,55,0.745,33,63,96,24,11,7,28,60,201
2005,Larry Hughes,SG,26,WAS,10,10,401,68,181,0.376,7,33,0.212,61,148,0.412,0.395,64,77,0.831,17,54,71,37,20,7,25,35,207
2005,Lindsey Hunter,SG,34,DET,25,0,374,36,113,0.319,8,36,0.222,28,77,0.364,0.354,16,22,0.727,10,30,40,39,22,7,15,45,96
2005,Steven Hunter,C,23,PHO,15,0,213,24,43,0.558,0,0,,24,43,0.558,0.558,12,20,0.6,17,21,38,3,1,18,8,25,60
2005,Andre Iguodala,SG,21,PHI,5,5,192,20,43,0.465,3,9,0.333,17,34,0.5,0.5,6,12,0.5,8,15,23,15,14,5,5,12,49
2005,Allen Iverson*,PG,29,PHI,5,5,238,59,126,0.468,12,29,0.414,47,97,0.485,0.516,26,29,0.897,0,11,11,50,10,2,21,12,156
2005,Bobby Jackson,SG,31,SAC,5,0,79,10,37,0.27,3,18,0.167,7,19,0.368,0.311,3,3,1,2,4,6,9,1,1,3,5,26
2005,Jim Jackson,SF,34,PHO,15,6,474,63,129,0.488,32,62,0.516,31,67,0.463,0.612,7,8,0.875,13,48,61,22,10,8,10,42,165
2005,Marc Jackson,C,30,PHI,5,0,65,5,20,0.25,0,0,,5,20,0.25,0.25,7,11,0.636,3,5,8,0,2,2,6,9,17
2005,Stephen Jackson,SF,26,IND,13,13,472,70,178,0.393,20,63,0.317,50,115,0.435,0.449,49,60,0.817,7,43,50,29,25,6,34,39,209
2005,Jerome James,C,29,SEA,11,11,295,57,111,0.514,0,0,,57,111,0.514,0.514,23,30,0.767,33,42,75,5,6,20,14,48,137
2005,Mike James,PG,29,HOU,7,0,171,29,62,0.468,0,9,0,29,53,0.547,0.468,23,24,0.958,2,11,13,16,6,2,10,17,81
2005,Antawn Jamison,PF,28,WAS,10,10,380,73,162,0.451,17,34,0.5,56,128,0.438,0.503,22,32,0.688,16,47,63,12,7,4,16,24,185
2005,Al Jefferson,PF,20,BOS,7,0,136,17,41,0.415,0,0,,17,41,0.415,0.415,9,12,0.75,17,28,45,2,4,8,4,16,43
2005,Richard Jefferson,SF,24,NJN,4,1,140,20,50,0.4,2,10,0.2,18,40,0.45,0.42,21,31,0.677,8,14,22,9,3,0,8,14,63
2005,Jared Jeffries,SF,23,WAS,10,10,247,24,49,0.49,3,6,0.5,21,43,0.488,0.52,13,17,0.765,19,22,41,18,9,9,13,34,64
2005,Anthony Johnson,PG,30,IND,13,4,316,27,77,0.351,8,23,0.348,19,54,0.352,0.403,29,36,0.806,4,34,38,66,13,5,25,28,91
2005,DerMarr Johnson,SG,24,DEN,4,2,78,11,20,0.55,4,11,0.364,7,9,0.778,0.65,3,3,1,3,5,8,3,2,2,0,9,29
2005,Joe Johnson,SF,23,PHO,9,9,355,63,125,0.504,20,36,0.556,43,89,0.483,0.584,23,33,0.697,7,32,39,30,10,4,10,18,169
2005,Dahntay Jones,SG,24,MEM,3,0,71,8,21,0.381,3,5,0.6,5,16,0.313,0.452,3,4,0.75,2,7,9,1,1,0,2,8,22
2005,Damon Jones,PG,28,MIA,15,15,498,62,129,0.481,39,91,0.429,23,38,0.605,0.632,18,30,0.6,3,38,41,60,7,0,17,24,181
2005,Eddie Jones,SF,33,MIA,15,15,601,71,156,0.455,32,80,0.4,39,76,0.513,0.558,31,42,0.738,10,77,87,39,18,9,22,57,205
2005,Fred Jones,SG,25,IND,13,0,234,16,54,0.296,9,23,0.391,7,31,0.226,0.38,12,13,0.923,1,22,23,13,8,2,15,13,53
2005,James Jones,SF,24,IND,13,0,214,19,46,0.413,10,25,0.4,9,21,0.429,0.522,4,9,0.444,5,22,27,10,7,7,4,18,52
2005,Jason Kidd*,PG,31,NJN,4,4,182,26,67,0.388,11,30,0.367,15,37,0.405,0.47,6,11,0.545,10,26,36,29,10,0,9,16,69
2005,Kyle Korver,SF,23,PHI,5,5,147,8,28,0.286,7,24,0.292,1,4,0.25,0.411,2,2,1,3,10,13,8,4,1,8,18,25
2005,Nenad Krstic,PF,21,NJN,4,4,154,27,48,0.563,0,0,,27,48,0.563,0.563,19,24,0.792,10,20,30,7,1,2,6,20,73
2005,Christian Laettner,PF,35,MIA,13,0,136,12,24,0.5,0,1,0,12,23,0.522,0.5,5,6,0.833,3,22,25,7,4,0,6,17,29
2005,Raef LaFrentz,PF,28,BOS,7,7,185,16,41,0.39,8,16,0.5,8,25,0.32,0.488,8,10,0.8,6,28,34,8,6,12,7,27,48
2005,Rashard Lewis,SF,25,SEA,8,8,312,43,106,0.406,5,25,0.2,38,81,0.469,0.429,44,50,0.88,11,32,43,13,3,3,16,25,135
2005,Shawn Marion,PF,26,PHO,15,15,635,108,223,0.484,18,43,0.419,90,180,0.5,0.525,30,39,0.769,46,131,177,23,21,26,21,47,264
2005,Kenyon Martin,PF,27,DEN,5,5,164,27,58,0.466,0,1,0,27,57,0.474,0.466,8,13,0.615,7,21,28,6,5,5,7,22,62
2005,Tony Massenburg,PF,37,SAS,9,0,28,1,6,0.167,0,0,,1,6,0.167,0.167,1,2,0.5,4,7,11,0,0,0,0,2,3
2005,Walter McCarty,PF,30,PHO,8,0,55,2,9,0.222,2,6,0.333,0,3,0,0.333,0,2,0,0,6,6,3,2,2,1,13,6
2005,Antonio McDyess,PF,30,DET,25,0,494,88,181,0.486,0,0,,88,181,0.486,0.486,25,36,0.694,46,101,147,19,14,23,25,78,201
2005,Tracy McGrady*,SF,25,HOU,7,7,301,78,171,0.456,17,46,0.37,61,125,0.488,0.506,42,51,0.824,12,40,52,47,11,10,26,20,215
2005,Aaron McKie,SG,32,PHI,5,0,85,3,7,0.429,1,3,0.333,2,4,0.5,0.5,0,0,,1,11,12,5,4,0,1,9,7
2005,Darko Milicic,C,19,DET,9,0,21,2,7,0.286,0,0,,2,7,0.286,0.286,1,1,1,1,3,4,1,0,1,1,3,5
2005,Andre Miller,PG,28,DEN,5,5,184,28,66,0.424,2,4,0.5,26,62,0.419,0.439,23,32,0.719,9,17,26,26,10,1,12,22,81
2005,Brad Miller,C,28,SAC,5,4,139,23,40,0.575,0,2,0,23,38,0.605,0.575,10,14,0.714,8,11,19,16,1,3,9,21,56
2005,Mike Miller,SF,24,MEM,4,4,110,18,37,0.486,8,17,0.471,10,20,0.5,0.595,4,4,1,0,10,10,11,0,3,5,7,48
2005,Reggie Miller*,SG,39,IND,13,13,430,62,143,0.434,21,66,0.318,41,77,0.532,0.507,48,51,0.941,4,36,40,20,10,1,21,28,193
2005,Yao Ming*,C,24,HOU,7,7,220,55,84,0.655,0,0,,55,84,0.655,0.655,40,55,0.727,23,31,54,5,2,19,19,31,150
2005,Cuttino Mobley,SG,29,SAC,5,5,159,31,70,0.443,7,25,0.28,24,45,0.533,0.493,5,7,0.714,4,10,14,9,6,2,6,13,74
2005,Nazr Mohammed,C,27,SAS,23,23,528,66,125,0.528,1,1,1,65,124,0.524,0.532,30,47,0.638,75,79,154,8,14,23,24,65,163
2005,Alonzo Mourning*,C,34,MIA,15,2,254,31,44,0.705,0,0,,31,44,0.705,0.705,29,52,0.558,21,51,72,5,5,33,22,49,91
2005,Ronald Murray,SG,25,SEA,4,0,62,4,19,0.211,0,2,0,4,17,0.235,0.211,4,7,0.571,2,4,6,5,0,2,2,8,12
2005,Dikembe Mutombo*,C,38,HOU,7,0,101,6,11,0.545,0,0,,6,11,0.545,0.545,10,13,0.769,11,24,35,2,2,7,7,15,22
2005,Eduardo Najera,PF,28,DEN,2,0,13,0,2,0,0,0,,0,2,0,0,0,0,,1,1,2,1,0,0,1,1,0
2005,Steve Nash*,PG,30,PHO,15,15,610,140,269,0.52,21,54,0.389,119,215,0.553,0.559,57,62,0.919,9,63,72,170,14,3,70,36,358
2005,Rasho Nesterovic,C,28,SAS,15,0,114,5,12,0.417,0,0,,5,12,0.417,0.417,0,2,0,11,15,26,2,1,5,4,16,10
2005,Andres Nocioni,SF,25,CHI,6,6,202,27,67,0.403,6,17,0.353,21,50,0.42,0.448,17,23,0.739,8,41,49,14,1,6,11,20,77
2005,Moochie Norris,PG,31,HOU,2,0,7,0,1,0,0,0,,0,1,0,0,0,0,,0,0,0,0,0,0,0,0,0
2005,Dirk Nowitzki,PF,26,DAL,13,13,551,103,256,0.402,10,30,0.333,93,226,0.412,0.422,92,111,0.829,25,106,131,43,18,21,33,42,308
2005,Jermaine O'Neal,PF,26,IND,13,13,476,77,211,0.365,0,3,0,77,208,0.37,0.365,54,72,0.75,21,83,104,29,7,34,36,48,208
2005,Shaquille O'Neal*,C,32,MIA,13,13,431,101,181,0.558,0,0,,101,181,0.558,0.558,50,106,0.472,19,83,102,25,5,19,42,52,252
2005,Greg Ostertag,C,31,SAC,2,0,26,3,3,1,0,0,,3,3,1,1,0,0,,4,5,9,0,1,2,2,4,6
2005,Bo Outlaw,PF,33,PHO,1,0,2,0,1,0,0,0,,0,1,0,0,0,0,,0,0,0,1,1,0,0,0,0
2005,Scott Padgett,PF,28,HOU,7,4,109,9,24,0.375,5,12,0.417,4,12,0.333,0.479,2,2,1,9,10,19,4,3,2,3,18,25
2005,Jannero Pargo,PG,25,CHI,5,0,76,18,51,0.353,13,32,0.406,5,19,0.263,0.48,3,5,0.6,1,4,5,10,3,0,8,14,52
2005,Tony Parker,PG,22,SAS,23,23,858,166,366,0.454,9,48,0.188,157,318,0.494,0.466,55,87,0.632,13,53,66,100,17,2,71,69,396
2005,Gary Payton*,PG,36,BOS,7,7,239,33,74,0.446,1,14,0.071,32,60,0.533,0.453,5,6,0.833,8,21,29,32,6,1,11,10,72
2005,Anthony Peeler,SG,35,WAS,7,0,43,1,9,0.111,0,3,0,1,6,0.167,0.111,2,2,1,0,7,7,3,1,0,3,4,4
2005,Kendrick Perkins,C,20,BOS,6,0,28,4,5,0.8,0,0,,4,5,0.8,0.8,1,3,0.333,3,3,6,0,0,3,3,7,9
2005,Wesley Person,SF,33,DEN,4,0,54,6,14,0.429,3,8,0.375,3,6,0.5,0.536,0,0,,1,0,1,1,1,0,1,0,15
2005,Eric Piatkowski,SG,34,CHI,5,0,66,6,19,0.316,5,13,0.385,1,6,0.167,0.447,6,7,0.857,1,8,9,3,4,1,1,3,23
2005,Paul Pierce,SF,27,BOS,7,7,277,47,93,0.505,7,27,0.259,40,66,0.606,0.543,59,68,0.868,7,47,54,32,13,10,19,18,160
2005,Zoran Planinic,PG,22,NJN,3,0,3,0,0,,0,0,,0,0,,,0,0,,0,0,0,0,0,0,0,0,0
2005,Scot Pollard,C,29,IND,9,0,67,6,15,0.4,0,0,,6,15,0.4,0.4,1,2,0.5,4,7,11,1,1,0,4,9,13
2005,James Posey,SF,28,MEM,4,0,100,11,25,0.44,7,15,0.467,4,10,0.4,0.58,10,13,0.769,1,12,13,4,2,1,5,14,39
2005,Vitaly Potapenko,C,29,SEA,5,0,37,5,10,0.5,0,0,,5,10,0.5,0.5,0,0,,3,4,7,0,0,0,0,8,10
2005,Tayshaun Prince,SF,24,DET,25,25,1023,133,307,0.433,22,60,0.367,111,247,0.449,0.469,48,60,0.8,56,102,158,83,26,9,37,50,336
2005,Laron Profit,SF,27,WAS,3,0,5,0,2,0,0,0,,0,2,0,0,0,0,,0,1,1,1,0,0,0,0,0
2005,Vladimir Radmanovic,PF,24,SEA,6,0,122,13,35,0.371,5,21,0.238,8,14,0.571,0.443,1,2,0.5,1,17,18,3,4,3,6,9,32
2005,Justin Reed,SF,23,BOS,6,0,22,2,6,0.333,0,2,0,2,4,0.5,0.333,3,4,0.75,0,1,1,0,0,0,2,2,7
2005,Jared Reiner,C,22,CHI,3,0,7,0,1,0,0,0,,0,1,0,0,0,0,,2,1,3,0,0,0,1,3,0
2005,Quentin Richardson,SG,24,PHO,15,15,564,62,154,0.403,32,82,0.39,30,72,0.417,0.506,23,36,0.639,24,53,77,25,19,3,15,53,179
2005,Luke Ridnour,PG,23,SEA,11,11,378,42,107,0.393,4,17,0.235,38,90,0.422,0.411,19,20,0.95,10,26,36,47,13,8,18,23,107
2005,Clifford Robinson,PF,38,NJN,4,0,71,11,27,0.407,4,14,0.286,7,13,0.538,0.481,2,2,1,2,8,10,5,3,1,0,20,28
2005,Glenn Robinson,SF,32,SAS,13,0,113,16,45,0.356,3,10,0.3,13,35,0.371,0.389,15,17,0.882,2,19,21,1,3,7,6,20,50
2005,Rodney Rogers,PF,33,PHI,4,0,49,6,13,0.462,3,8,0.375,3,5,0.6,0.577,5,7,0.714,0,4,4,1,0,2,1,4,20
2005,Michael Ruffin,C,28,WAS,9,0,156,7,10,0.7,0,0,,7,10,0.7,0.7,9,16,0.563,15,22,37,9,3,3,4,33,23
2005,Bryon Russell,SF,34,DEN,3,0,9,0,1,0,0,1,0,0,0,,0,3,3,1,0,0,0,0,0,0,0,0,3
2005,John Salmons,SG,25,PHI,2,0,4,0,0,,0,0,,0,0,,,0,0,,0,0,0,1,0,0,0,0,0
2005,Brian Scalabrine,PF,26,NJN,4,3,61,2,11,0.182,1,4,0.25,1,7,0.143,0.227,4,4,1,2,5,7,2,1,2,4,6,9
2005,Brian Skinner,C,28,SAC,4,1,47,4,8,0.5,0,0,,4,8,0.5,0.5,0,0,,6,5,11,2,2,4,5,5,8
2005,Jabari Smith,PF,27,NJN,3,0,4,0,0,,0,0,,0,0,,,0,0,,0,0,0,0,0,0,0,2,0
2005,Steve Smith,SG,35,MIA,3,0,8,0,2,0,0,0,,0,2,0,0,0,0,,0,0,0,0,0,0,0,0,0
2005,Darius Songaila,PF,26,SAC,5,0,75,8,19,0.421,0,0,,8,19,0.421,0.421,4,5,0.8,6,8,14,3,2,1,2,14,20
2005,Jerry Stackhouse,SG,30,DAL,13,0,403,68,176,0.386,16,40,0.4,52,136,0.382,0.432,57,66,0.864,20,33,53,30,8,3,21,22,209
2005,Peja Stojakovic,SF,27,SAC,5,5,203,39,83,0.47,11,30,0.367,28,53,0.528,0.536,21,22,0.955,6,20,26,7,4,1,2,15,110
2005,Amar'e Stoudemire,C,22,PHO,15,15,601,153,284,0.539,0,3,0,153,281,0.544,0.539,143,183,0.781,60,100,160,18,10,30,47,59,449
2005,Bob Sura,PG,31,HOU,7,7,182,20,46,0.435,7,13,0.538,13,33,0.394,0.511,8,12,0.667,6,21,27,14,7,0,11,15,55
2005,Stromile Swift,PF,25,MEM,3,0,48,12,20,0.6,0,0,,12,20,0.6,0.6,4,7,0.571,7,7,14,1,1,0,2,3,28
2005,Jason Terry,PG,27,DAL,13,13,501,81,160,0.506,27,55,0.491,54,105,0.514,0.591,38,43,0.884,9,45,54,60,17,7,30,28,227
2005,Billy Thomas,SF,29,NJN,2,0,2,0,1,0,0,0,,0,1,0,0,0,0,,0,0,0,0,0,0,0,0,0
2005,Etan Thomas,C,26,WAS,8,0,126,19,29,0.655,0,0,,19,29,0.655,0.655,10,22,0.455,12,24,36,2,0,7,9,23,48
2005,Kenny Thomas,PF,27,SAC,5,5,153,23,45,0.511,0,0,,23,45,0.511,0.511,14,20,0.7,17,27,44,12,4,2,8,22,60
2005,Jamaal Tinsley,PG,26,IND,9,9,247,32,89,0.36,2,18,0.111,30,71,0.423,0.371,12,21,0.571,6,24,30,51,14,3,27,31,78
2005,Beno Udrih,PG,22,SAS,21,0,241,28,78,0.359,10,37,0.27,18,41,0.439,0.423,12,14,0.857,4,13,17,22,9,1,20,20,78
2005,Keith Van Horn,PF,29,DAL,3,0,33,7,15,0.467,0,4,0,7,11,0.636,0.467,8,9,0.889,3,3,6,1,1,0,1,6,22
2005,Dwyane Wade,SG,23,MIA,14,14,571,136,281,0.484,1,10,0.1,135,271,0.498,0.486,111,139,0.799,23,57,80,93,22,16,62,43,384
2005,Antoine Walker,PF,28,BOS,6,6,224,43,104,0.413,7,19,0.368,36,85,0.424,0.447,7,11,0.636,16,28,44,14,7,6,18,19,100
2005,Ben Wallace,C,30,DET,25,25,979,102,212,0.481,0,4,0,102,208,0.49,0.481,47,102,0.461,95,187,282,25,43,59,30,65,251
2005,Rasheed Wallace,PF,30,DET,25,25,826,136,310,0.439,29,86,0.337,107,224,0.478,0.485,40,54,0.741,39,134,173,32,26,44,38,95,341
2005,Earl Watson,PG,25,MEM,4,0,74,8,24,0.333,1,9,0.111,7,15,0.467,0.354,2,2,1,3,7,10,15,3,1,2,11,19
2005,Clarence Weatherspoon,PF,34,HOU,1,0,1,0,0,,0,0,,0,0,,,0,0,,0,0,0,0,0,0,0,1,0
2005,Chris Webber,PF,31,PHI,5,5,186,39,95,0.411,5,14,0.357,34,81,0.42,0.437,12,16,0.75,12,17,29,14,6,1,11,20,95
2005,Bonzi Wells,SG,28,MEM,2,0,25,4,9,0.444,0,0,,4,9,0.444,0.444,6,6,1,0,4,4,3,2,1,1,1,14
2005,David Wesley,SG,34,HOU,7,7,280,19,54,0.352,10,21,0.476,9,33,0.273,0.444,9,13,0.692,4,17,21,23,9,1,9,20,57
2005,Delonte West,SG,21,BOS,7,3,115,11,21,0.524,5,11,0.455,6,10,0.6,0.643,2,4,0.5,2,7,9,4,7,1,2,17,29
2005,Damien Wilkins,SF,25,SEA,7,0,136,16,36,0.444,3,11,0.273,13,25,0.52,0.486,4,9,0.444,9,9,18,3,10,1,8,17,39
2005,Jason Williams,PG,29,MEM,4,4,114,28,53,0.528,10,21,0.476,18,32,0.563,0.623,2,2,1,1,8,9,21,6,0,8,7,68
2005,Corliss Williamson,PF,31,SAC,5,0,40,6,16,0.375,0,1,0,6,15,0.4,0.375,14,18,0.778,4,2,6,3,1,2,4,11,26
2005,Lorenzen Wright,C,29,MEM,4,4,85,16,28,0.571,0,0,,16,28,0.571,0.571,1,2,0.5,6,14,20,9,1,1,2,10,33
2006,Shareef Abdur-Rahim,PF,29,SAC,6,0,129,23,43,0.535,0,3,0,23,40,0.575,0.535,9,15,0.6,8,21,29,7,2,0,13,27,55
2006,Malik Allen,PF,27,CHI,6,6,116,14,30,0.467,0,0,,14,30,0.467,0.467,0,1,0,5,13,18,7,2,6,10,16,28
2006,Derek Anderson,SG,31,MIA,8,0,66,6,20,0.3,5,14,0.357,1,6,0.167,0.425,7,8,0.875,0,9,9,5,2,0,3,13,24
2006,Shandon Anderson,SF,32,MIA,13,0,90,4,13,0.308,1,3,0.333,3,10,0.3,0.346,4,6,0.667,3,9,12,4,0,1,6,8,13
2006,Carmelo Anthony,SF,21,DEN,5,5,193,33,99,0.333,0,4,0,33,95,0.347,0.333,39,52,0.75,12,21,33,14,4,1,15,20,105
2006,Gilbert Arenas,PG,24,WAS,6,6,284,65,140,0.464,20,46,0.435,45,94,0.479,0.536,54,70,0.771,7,26,33,32,13,4,20,21,204
2006,Darrell Armstrong,PG,37,DAL,11,0,47,3,15,0.2,0,7,0,3,8,0.375,0.2,2,2,1,1,6,7,2,3,1,1,9,8
2006,Chucky Atkins,PG,31,MEM,4,4,103,15,37,0.405,4,11,0.364,11,26,0.423,0.459,5,8,0.625,0,3,3,12,2,0,4,15,39
2006,Leandro Barbosa,SG,23,PHO,20,3,632,103,219,0.47,27,69,0.391,76,150,0.507,0.532,50,58,0.862,5,27,32,54,15,4,29,66,283
2006,Brent Barry,SG,34,SAS,13,2,301,34,61,0.557,17,34,0.5,17,27,0.63,0.697,16,21,0.762,3,29,32,22,9,3,9,29,101
2006,Shane Battier,SF,27,MEM,4,4,129,10,20,0.5,2,7,0.286,8,13,0.615,0.55,2,6,0.333,7,16,23,2,4,2,8,16,24
2006,Charlie Bell,SG,26,MIL,5,0,108,17,43,0.395,5,11,0.455,12,32,0.375,0.453,7,7,1,2,1,3,7,3,2,4,15,46
2006,Raja Bell,SG,29,PHO,17,17,673,79,165,0.479,40,86,0.465,39,79,0.494,0.6,34,41,0.829,8,40,48,37,11,4,10,70,232
2006,Mike Bibby,PG,27,SAC,6,6,255,32,92,0.348,9,26,0.346,23,66,0.348,0.397,27,30,0.9,6,17,23,31,9,0,18,17,100
2006,Chauncey Billups,PG,29,DET,18,18,705,93,229,0.406,32,94,0.34,61,135,0.452,0.476,105,116,0.905,7,54,61,117,22,2,43,43,323
2006,Andrew Bogut,PF,21,MIL,5,5,172,20,46,0.435,0,0,,20,46,0.435,0.435,3,8,0.375,9,22,31,17,3,0,8,21,43
2006,Bruce Bowen,SF,34,SAS,13,13,442,32,61,0.525,15,30,0.5,17,31,0.548,0.648,1,2,0.5,6,22,28,16,11,8,9,42,80
2006,Earl Boykins,PG,29,DEN,5,0,140,19,59,0.322,4,19,0.211,15,40,0.375,0.356,13,17,0.765,3,4,7,20,4,0,3,6,55
2006,Elton Brand,PF,26,LAC,12,12,517,124,225,0.551,0,1,0,124,224,0.554,0.551,57,76,0.75,51,72,123,48,11,31,29,34,305
2006,Kwame Brown,C,23,LAL,7,7,225,34,65,0.523,0,0,,34,65,0.523,0.523,22,31,0.71,17,29,46,7,2,6,12,21,90
2006,Kobe Bryant,SG,27,LAL,7,7,314,72,145,0.497,14,35,0.4,58,110,0.527,0.545,37,48,0.771,4,40,44,36,8,3,33,25,195
2006,Greg Buckner,SG,29,DEN,5,4,137,23,55,0.418,10,32,0.313,13,23,0.565,0.509,7,8,0.875,3,11,14,6,3,1,1,12,63
2006,Pat Burke,C,32,PHO,3,0,7,2,4,0.5,1,2,0.5,1,2,0.5,0.625,0,1,0,1,2,3,0,0,1,0,0,5
2006,Antonio Burks,PG,25,MEM,2,0,13,1,1,1,0,0,,1,1,1,1,1,2,0.5,0,1,1,2,1,0,0,2,3
2006,Caron Butler,SF,25,WAS,6,6,262,42,101,0.416,3,14,0.214,39,87,0.448,0.431,24,29,0.828,16,47,63,16,12,4,14,31,111
2006,Andrew Bynum,C,18,LAL,1,0,2,0,1,0,0,0,,0,1,0,0,0,0,,0,0,0,0,0,0,0,0,0
2006,Marcus Camby,C,31,DEN,5,5,175,26,62,0.419,0,0,,26,62,0.419,0.419,5,9,0.556,13,42,55,11,4,14,4,14,57
2006,Brian Cardinal,PF,28,MEM,3,0,22,1,2,0.5,1,2,0.5,0,0,,0.75,0,0,,1,3,4,1,1,0,0,2,3
2006,Vince Carter,SG,29,NJN,11,11,450,113,244,0.463,14,58,0.241,99,186,0.532,0.492,86,108,0.796,16,61,77,58,20,6,26,34,326
2006,Sam Cassell,PG,36,LAC,12,12,404,73,167,0.437,15,43,0.349,58,124,0.468,0.482,55,68,0.809,9,39,48,69,8,2,28,35,216
2006,Kelvin Cato,C,31,DET,4,0,15,3,5,0.6,0,0,,3,5,0.6,0.6,0,0,,3,4,7,0,0,0,0,2,6
2006,Tyson Chandler,C,23,CHI,6,0,104,4,6,0.667,0,0,,4,6,0.667,0.667,3,10,0.3,8,19,27,3,2,2,6,29,11
2006,Jason Collins,C,27,NJN,11,11,302,9,25,0.36,0,0,,9,25,0.36,0.36,13,22,0.591,20,35,55,3,5,2,9,55,31
2006,Brian Cook,PF,25,LAL,7,0,78,18,46,0.391,4,11,0.364,14,35,0.4,0.435,4,4,1,11,11,22,8,1,0,3,15,44
2006,Austin Croshere,PF,30,IND,6,2,175,12,38,0.316,9,23,0.391,3,15,0.2,0.434,16,18,0.889,5,17,22,7,5,0,6,11,49
2006,Erick Dampier,C,30,DAL,19,2,454,34,63,0.54,0,1,0,34,62,0.548,0.54,27,44,0.614,55,72,127,6,11,24,12,75,95
2006,Antonio Daniels,SG,30,WAS,6,0,216,28,52,0.538,3,11,0.273,25,41,0.61,0.567,20,22,0.909,2,15,17,20,3,1,10,4,79
2006,Marquis Daniels,SG,25,DAL,20,0,222,25,56,0.446,2,5,0.4,23,51,0.451,0.464,16,21,0.762,10,11,21,26,5,1,12,26,68
2006,Dale Davis,C,36,DET,8,0,36,0,6,0,0,0,,0,6,0,0,2,4,0.5,1,8,9,1,0,0,3,11,2
2006,Carlos Delfino,SG,23,DET,8,0,32,1,6,0.167,1,2,0.5,0,4,0,0.25,2,2,1,0,4,4,2,1,0,6,4,5
2006,Tony Delk,PG,32,DET,16,0,138,19,47,0.404,3,15,0.2,16,32,0.5,0.436,7,10,0.7,4,14,18,8,6,0,4,14,48
2006,Luol Deng,SF,20,CHI,6,0,180,24,56,0.429,1,5,0.2,23,51,0.451,0.438,12,21,0.571,8,21,29,3,5,4,5,13,61
2006,Boris Diaw,PF,23,PHO,20,20,796,152,289,0.526,3,7,0.429,149,282,0.528,0.531,67,88,0.761,39,94,133,104,18,22,55,64,374
2006,DeSagana Diop,C,24,DAL,22,18,407,24,39,0.615,0,0,,24,39,0.615,0.615,11,18,0.611,40,69,109,2,14,28,11,81,59
2006,Michael Doleac,C,28,MIA,8,0,72,7,13,0.538,0,0,,7,13,0.538,0.538,2,2,1,6,16,22,0,1,0,3,12,16
2006,Chris Duhon,PG,23,CHI,6,0,131,9,25,0.36,7,16,0.438,2,9,0.222,0.5,5,6,0.833,1,15,16,13,2,0,5,13,30
2006,Tim Duncan,PF,29,SAS,13,13,493,121,211,0.573,0,2,0,121,209,0.579,0.573,94,131,0.718,33,104,137,43,11,25,34,50,336
2006,Francisco Elson,C,29,DEN,5,2,75,3,5,0.6,0,0,,3,5,0.6,0.6,0,0,,5,6,11,2,4,0,3,13,6
2006,Maurice Evans,SG,27,DET,16,0,101,16,30,0.533,7,11,0.636,9,19,0.474,0.65,14,16,0.875,6,8,14,3,1,1,2,10,53
2006,Reggie Evans,PF,25,DEN,5,0,69,3,7,0.429,0,2,0,3,5,0.6,0.429,13,18,0.722,8,15,23,0,2,1,6,11,19
2006,Daniel Ewing,SG,22,LAC,6,0,5,1,1,1,0,0,,1,1,1,1,0,0,,0,0,0,0,0,0,0,0,2
2006,Michael Finley,SG,32,SAS,13,4,411,50,105,0.476,18,47,0.383,32,58,0.552,0.562,18,20,0.9,1,48,49,18,8,3,9,19,136
2006,T.J. Ford,PG,22,MIL,5,5,162,25,51,0.49,2,5,0.4,23,46,0.5,0.51,11,12,0.917,3,17,20,32,3,0,16,20,63
2006,Jeff Foster,C,29,IND,4,4,80,4,11,0.364,0,0,,4,11,0.364,0.364,3,4,0.75,11,13,24,3,4,1,0,9,11
2006,Dan Gadzuric,C,27,MIL,4,0,16,8,9,0.889,0,0,,8,9,0.889,0.889,1,2,0.5,2,2,4,0,0,1,0,3,17
2006,Francisco Garcia,SF,24,SAC,6,0,41,5,11,0.455,1,4,0.25,4,7,0.571,0.5,2,2,1,0,2,2,1,2,2,0,5,13
2006,Pau Gasol,PF,25,MEM,4,4,158,29,67,0.433,0,1,0,29,66,0.439,0.433,23,30,0.767,4,23,27,12,2,5,11,11,81
2006,Devean George,SF,28,LAL,7,0,121,13,34,0.382,9,21,0.429,4,13,0.308,0.515,2,5,0.4,2,14,16,4,4,1,0,13,37
2006,Eddie Gill,PG,27,IND,2,0,1,0,0,,0,0,,0,0,,,0,0,,0,0,0,0,0,0,1,0,0
2006,Manu Ginobili,SG,28,SAS,13,11,426,76,157,0.484,14,42,0.333,62,115,0.539,0.529,73,87,0.839,9,50,59,39,19,7,33,43,239
2006,Drew Gooden,PF,24,CLE,13,13,282,45,85,0.529,0,0,,45,85,0.529,0.529,17,18,0.944,31,67,98,8,3,2,18,40,107
2006,Ben Gordon,SG,22,CHI,6,6,245,43,106,0.406,15,41,0.366,28,65,0.431,0.476,25,37,0.676,5,15,20,18,6,0,17,12,126
2006,Danny Granger,SF,22,IND,6,3,162,18,34,0.529,9,16,0.563,9,18,0.5,0.662,4,4,1,7,24,31,10,4,7,7,20,49
2006,Brian Grant,C,33,PHO,5,0,12,1,3,0.333,0,0,,1,3,0.333,0.333,0,2,0,2,0,2,0,0,0,0,7,2
2006,Adrian Griffin,SG,31,DAL,20,8,349,32,59,0.542,0,0,,32,59,0.542,0.542,7,8,0.875,28,43,71,24,15,2,11,42,71
2006,Richard Hamilton,SG,27,DET,18,18,690,128,310,0.413,14,40,0.35,114,270,0.422,0.435,97,114,0.851,16,36,52,48,17,5,39,59,367
2006,Othella Harrington,C,32,CHI,3,0,15,0,3,0,0,0,,0,3,0,0,0,0,,0,2,2,0,1,0,0,2,0
2006,Devin Harris,PG,22,DAL,23,15,558,82,171,0.48,0,8,0,82,163,0.503,0.48,52,74,0.703,15,24,39,50,18,3,42,69,216
2006,David Harrison,C,23,IND,6,0,31,3,9,0.333,0,0,,3,9,0.333,0.333,7,12,0.583,1,4,5,0,1,1,4,11,13
2006,Jason Hart,PG,27,SAC,5,0,52,4,13,0.308,0,0,,4,13,0.308,0.308,2,2,1,1,1,2,3,3,0,4,8,10
2006,Udonis Haslem,PF,25,MIA,22,22,650,74,150,0.493,0,1,0,74,149,0.497,0.493,41,60,0.683,49,113,162,17,13,7,31,79,189
2006,Brendan Haywood,C,26,WAS,6,6,155,15,22,0.682,0,0,,15,22,0.682,0.682,13,25,0.52,7,12,19,5,2,11,7,22,43
2006,Alan Henderson,C,33,CLE,2,0,9,0,2,0,0,0,,0,2,0,0,0,0,,1,1,2,0,0,0,0,1,0
2006,Kirk Hinrich,PG,25,CHI,6,6,234,39,94,0.415,9,26,0.346,30,68,0.441,0.463,36,42,0.857,0,20,20,46,8,2,24,22,123
2006,Robert Horry,PF,35,SAS,13,5,224,15,37,0.405,6,17,0.353,9,20,0.45,0.486,19,26,0.731,19,29,48,11,5,9,10,31,55
2006,Eddie House,PG,27,PHO,14,0,130,19,52,0.365,3,14,0.214,16,38,0.421,0.394,3,4,0.75,0,9,9,6,1,2,5,10,44
2006,Josh Howard,SF,25,DAL,23,23,824,140,309,0.453,24,65,0.369,116,244,0.475,0.492,80,99,0.808,41,130,171,32,23,14,52,85,384
2006,Larry Hughes,SG,27,CLE,9,8,336,36,113,0.319,5,18,0.278,31,95,0.326,0.341,23,31,0.742,9,18,27,36,20,1,16,34,100
2006,Lindsey Hunter,PG,35,DET,18,0,217,26,78,0.333,14,44,0.318,12,34,0.353,0.423,10,10,1,8,11,19,29,15,1,14,41,76
2006,Zydrunas Ilgauskas,C,30,CLE,13,13,354,54,119,0.454,0,0,,54,119,0.454,0.454,27,36,0.75,33,49,82,10,5,27,24,46,135
2006,Didier Ilunga-Mbenga,C,25,DAL,7,0,25,1,3,0.333,0,0,,1,3,0.333,0.333,2,2,1,1,7,8,0,0,1,3,9,4
2006,Bobby Jackson,PG,32,MEM,4,0,100,12,29,0.414,4,11,0.364,8,18,0.444,0.483,5,7,0.714,0,8,8,5,1,0,14,7,33
2006,Jermaine Jackson,PG,29,MIL,2,0,4,0,2,0,0,0,,0,2,0,0,0,0,,0,0,0,2,0,0,0,1,0
2006,Jim Jackson,SF,35,LAL,3,0,21,2,6,0.333,0,1,0,2,5,0.4,0.333,0,0,,2,1,3,2,1,1,2,4,4
2006,Stephen Jackson,SG,27,IND,6,6,227,30,82,0.366,6,26,0.231,24,56,0.429,0.402,14,18,0.778,5,22,27,20,4,1,15,23,80
2006,LeBron James,SF,21,CLE,13,13,604,146,307,0.476,21,63,0.333,125,244,0.512,0.51,87,118,0.737,22,83,105,76,18,9,65,44,400
2006,Antawn Jamison,SF,29,WAS,6,6,253,42,99,0.424,10,32,0.313,32,67,0.478,0.475,21,27,0.778,9,34,43,18,6,2,11,23,115
2006,Sarunas Jasikevicius,PG,29,IND,6,0,66,7,19,0.368,2,9,0.222,5,10,0.5,0.421,1,2,0.5,1,5,6,6,0,1,5,7,17
2006,Richard Jefferson,SF,25,NJN,11,11,437,90,165,0.545,12,29,0.414,78,136,0.574,0.582,52,63,0.825,7,38,45,45,10,4,30,32,244
2006,Jared Jeffries,PF,24,WAS,6,6,215,17,43,0.395,1,7,0.143,16,36,0.444,0.407,13,17,0.765,20,17,37,9,1,7,11,19,48
2006,Anthony Johnson,PG,31,IND,6,6,242,45,87,0.517,8,20,0.4,37,67,0.552,0.563,22,33,0.667,8,22,30,31,6,0,14,17,120
2006,DerMarr Johnson,SG,25,DEN,3,0,34,3,13,0.231,1,10,0.1,2,3,0.667,0.269,0,0,,2,8,10,2,0,1,1,1,7
2006,Ervin Johnson,C,38,MIL,3,0,11,0,1,0,0,0,,0,1,0,0,2,2,1,0,4,4,0,1,0,1,1,2
2006,Dahntay Jones,SF,25,MEM,4,0,46,5,7,0.714,0,0,,5,7,0.714,0.714,7,10,0.7,1,6,7,0,1,0,2,7,17
2006,Damon Jones,PG,29,CLE,13,0,181,8,26,0.308,5,18,0.278,3,8,0.375,0.404,3,4,0.75,2,14,16,12,2,0,3,17,24
2006,Eddie Jones,SG,34,MEM,4,3,119,14,29,0.483,3,7,0.429,11,22,0.5,0.534,10,15,0.667,3,8,11,10,3,1,1,10,41
2006,Fred Jones,SG,26,IND,6,1,167,15,36,0.417,6,16,0.375,9,20,0.45,0.5,11,12,0.917,2,18,20,15,6,1,8,13,47
2006,James Jones,SF,25,PHO,20,6,353,28,82,0.341,8,26,0.308,20,56,0.357,0.39,22,26,0.846,16,56,72,5,5,18,9,25,86
2006,Chris Kaman,C,23,LAC,11,10,324,51,86,0.593,0,0,,51,86,0.593,0.593,16,21,0.762,21,67,88,10,5,9,33,38,118
2006,Jason Kapono,SF,24,MIA,1,0,2,0,0,,0,0,,0,0,,,0,0,,0,0,0,0,0,0,0,0,0
2006,Jason Kidd*,PG,32,NJN,11,11,450,49,132,0.371,15,50,0.3,34,82,0.415,0.428,19,23,0.826,22,62,84,106,17,2,24,31,132
2006,Linas Kleiza,PF,21,DEN,3,0,14,3,8,0.375,0,1,0,3,7,0.429,0.375,0,0,,1,3,4,2,0,0,0,3,6
2006,Nenad Krstic,PF,22,NJN,11,11,366,65,129,0.504,0,0,,65,129,0.504,0.504,32,45,0.711,25,50,75,8,5,10,22,46,162
2006,Toni Kukoc,PF,37,MIL,3,0,53,8,14,0.571,5,8,0.625,3,6,0.5,0.75,1,2,0.5,0,5,5,9,1,0,3,8,22
2006,Shaun Livingston,PG,20,LAC,12,0,332,36,76,0.474,1,1,1,35,75,0.467,0.48,17,21,0.81,16,40,56,57,7,6,23,31,90
2006,Corey Maggette,SF,26,LAC,12,2,292,57,122,0.467,8,24,0.333,49,98,0.5,0.5,61,67,0.91,7,80,87,17,7,5,26,39,183
2006,Jamaal Magloire,C,27,MIL,5,5,135,18,38,0.474,0,0,,18,38,0.474,0.474,9,15,0.6,11,29,40,5,2,6,6,14,45
2006,Shawn Marion,PF,27,PHO,20,20,849,163,333,0.489,22,70,0.314,141,263,0.536,0.523,59,67,0.881,57,176,233,31,37,23,22,65,407
2006,Donyell Marshall,PF,32,CLE,13,0,345,45,104,0.433,18,46,0.391,27,58,0.466,0.519,15,17,0.882,24,49,73,8,7,9,13,24,123
2006,Kenyon Martin,PF,28,DEN,2,0,35,4,13,0.308,0,0,,4,13,0.308,0.308,1,2,0.5,6,3,9,1,4,2,3,5,9
2006,Kevin Martin,SG,22,SAC,6,1,197,22,54,0.407,6,19,0.316,16,35,0.457,0.463,29,29,1,10,20,30,3,3,2,2,11,79
2006,Walter McCarty,SF,31,LAC,8,0,10,1,4,0.25,0,1,0,1,3,0.333,0.25,0,0,,0,1,1,0,0,0,0,2,2
2006,Antonio McDyess,PF,31,DET,18,0,370,57,102,0.559,0,1,0,57,101,0.564,0.559,23,42,0.548,39,70,109,11,8,13,14,54,137
2006,Aaron McKie,PG,33,LAL,1,0,8,0,0,,0,0,,0,0,,,0,0,,0,0,0,0,0,0,0,0,0
2006,Andre Miller,PG,29,DEN,5,5,182,34,77,0.442,0,0,,34,77,0.442,0.442,14,17,0.824,8,14,22,36,5,1,16,12,82
2006,Brad Miller,C,29,SAC,6,6,166,21,52,0.404,1,7,0.143,20,45,0.444,0.413,12,13,0.923,3,15,18,15,7,5,7,20,55
2006,Mike Miller,SG,25,MEM,4,1,107,12,30,0.4,1,8,0.125,11,22,0.5,0.417,9,9,1,1,14,15,7,2,2,8,11,34
2006,Cuttino Mobley,SG,30,LAC,12,12,473,61,143,0.427,11,30,0.367,50,113,0.442,0.465,26,29,0.897,10,47,57,24,8,3,23,28,159
2006,Nazr Mohammed,C,28,SAS,8,3,94,11,15,0.733,1,1,1,10,14,0.714,0.767,13,18,0.722,15,16,31,1,3,6,8,17,36
2006,Alonzo Mourning*,C,35,MIA,21,0,226,26,37,0.703,0,0,,26,37,0.703,0.703,28,42,0.667,17,44,61,3,5,24,17,49,80
2006,Lamond Murray,SF,32,NJN,11,0,197,21,54,0.389,12,34,0.353,9,20,0.45,0.5,9,11,0.818,9,29,38,2,3,0,3,25,63
2006,Ronald Murray,SG,26,CLE,13,5,399,37,112,0.33,5,24,0.208,32,88,0.364,0.353,26,32,0.813,11,31,42,21,9,2,9,27,105
2006,Bostjan Nachbar,SF,25,NJN,1,0,1,0,0,,0,0,,0,0,,,0,0,,0,0,0,0,0,0,0,0,0
2006,Eduardo Najera,PF,29,DEN,4,3,89,3,14,0.214,0,0,,3,14,0.214,0.214,2,4,0.5,4,11,15,2,3,0,4,13,8
2006,Steve Nash*,PG,31,PHO,20,20,798,146,291,0.502,32,87,0.368,114,204,0.559,0.557,83,91,0.912,9,64,73,204,8,5,67,38,407
2006,Rasho Nesterovic,C,29,SAS,9,1,114,11,19,0.579,1,1,1,10,18,0.556,0.605,2,2,1,7,23,30,1,2,5,2,17,25
2006,Ira Newble,SG,31,CLE,5,0,11,3,3,1,1,1,1,2,2,1,1.167,0,0,,1,1,2,0,1,0,1,1,7
2006,Andres Nocioni,PF,26,CHI,6,6,230,47,84,0.56,10,21,0.476,37,63,0.587,0.619,30,35,0.857,5,48,53,9,5,2,14,21,134
2006,Dirk Nowitzki,PF,27,DAL,23,23,983,196,419,0.468,23,67,0.343,173,352,0.491,0.495,205,229,0.895,47,221,268,67,25,14,49,64,620
2006,Jermaine O'Neal,PF,27,IND,6,6,216,44,84,0.524,0,2,0,44,82,0.537,0.524,38,53,0.717,9,36,45,10,3,14,26,28,126
2006,Shaquille O'Neal*,C,33,MIA,23,23,759,178,291,0.612,0,0,,178,291,0.612,0.612,68,182,0.374,75,150,225,39,11,34,85,84,424
2006,Fabricio Oberto,C,30,SAS,7,0,34,3,9,0.333,0,0,,3,9,0.333,0.333,1,4,0.25,3,3,6,1,1,3,2,7,7
2006,Lamar Odom,PF,26,LAL,7,7,314,49,99,0.495,6,30,0.2,43,69,0.623,0.525,30,45,0.667,15,62,77,34,3,8,23,23,134
2006,Scott Padgett,PF,29,NJN,3,0,9,1,2,0.5,0,1,0,1,1,1,0.5,1,2,0.5,2,1,3,0,1,0,0,3,3
2006,Jannero Pargo,PG,26,CHI,5,0,19,5,12,0.417,3,5,0.6,2,7,0.286,0.542,4,5,0.8,1,5,6,3,0,0,3,0,17
2006,Smush Parker,PG,24,LAL,7,7,258,24,72,0.333,4,26,0.154,20,46,0.435,0.361,10,10,1,9,12,21,11,15,1,12,24,62
2006,Tony Parker,PG,23,SAS,13,13,475,104,226,0.46,2,9,0.222,102,217,0.47,0.465,64,79,0.81,8,39,47,50,13,1,40,31,274
2006,Ruben Patterson,SG,30,DEN,4,1,58,9,17,0.529,0,0,,9,17,0.529,0.529,2,5,0.4,5,1,6,3,1,0,3,6,20
2006,Sasha Pavlovic,SG,22,CLE,3,0,4,0,2,0,0,1,0,0,1,0,0,0,0,,0,1,1,0,0,0,0,0,0
2006,Gary Payton*,PG,37,MIA,23,0,560,49,116,0.422,17,58,0.293,32,58,0.552,0.496,18,25,0.72,6,34,40,36,23,3,18,55,133
2006,Eric Piatkowski,SG,35,CHI,6,0,28,3,6,0.5,2,5,0.4,1,1,1,0.667,2,2,1,1,4,5,1,0,1,0,1,10
2006,Zoran Planinic,PG,23,NJN,3,0,6,0,1,0,0,0,,0,1,0,0,0,2,0,0,1,1,2,1,0,1,1,0
2006,Scot Pollard,C,30,IND,4,0,15,0,1,0,0,0,,0,1,0,0,0,0,,1,4,5,0,1,0,1,5,0
2006,James Posey,SF,29,MIA,22,1,607,49,114,0.43,35,83,0.422,14,31,0.452,0.583,27,37,0.73,15,110,125,20,17,2,11,70,160
2006,Vitaly Potapenko,C,30,SAC,4,0,9,2,4,0.5,0,0,,2,4,0.5,0.5,0,0,,1,0,1,0,1,0,0,2,4
2006,Josh Powell,PF,23,DAL,6,0,25,0,4,0,0,0,,0,4,0,0,0,0,,2,0,2,1,0,0,1,5,0
2006,Ronnie Price,PG,22,SAC,4,0,9,0,3,0,0,0,,0,3,0,0,0,0,,0,0,0,1,0,0,0,1,0
2006,Tayshaun Prince,SF,25,DET,18,18,745,106,231,0.459,21,46,0.457,85,185,0.459,0.504,63,76,0.829,43,59,102,54,12,15,31,23,296
2006,Vladimir Radmanovic,PF,25,LAC,12,2,246,31,66,0.47,19,41,0.463,12,25,0.48,0.614,16,23,0.696,9,39,48,13,7,6,8,35,97
2006,Zeljko Rebraca,C,33,LAC,3,0,22,1,3,0.333,0,0,,1,3,0.333,0.333,0,0,,1,3,4,0,0,1,2,6,2
2006,Michael Redd,SG,26,MIL,5,5,185,44,84,0.524,7,15,0.467,37,69,0.536,0.565,41,46,0.891,16,11,27,8,4,0,10,11,136
2006,Clifford Robinson,PF,39,NJN,8,0,198,13,39,0.333,6,19,0.316,7,20,0.35,0.41,4,5,0.8,2,24,26,5,9,3,10,28,36
2006,Quinton Ross,SF,24,LAC,12,10,294,39,73,0.534,0,0,,39,73,0.534,0.534,14,16,0.875,8,24,32,9,7,8,9,36,92
2006,Michael Ruffin,C,29,WAS,6,0,70,1,2,0.5,0,0,,1,2,0.5,0.5,0,2,0,6,10,16,4,1,2,2,10,2
2006,Luke Schenscher,C,23,CHI,3,0,17,2,2,1,0,0,,2,2,1,1,3,4,0.75,3,4,7,0,0,0,1,2,7
2006,Wayne Simien,PF,22,MIA,2,0,7,0,3,0,0,0,,0,3,0,0,0,0,,1,0,1,0,0,0,1,1,0
2006,Bobby Simmons,SF,25,MIL,5,5,159,14,42,0.333,5,12,0.417,9,30,0.3,0.393,0,0,,4,14,18,10,9,1,6,11,33
2006,James Singleton,SF,24,LAC,7,0,12,1,3,0.333,0,2,0,1,1,1,0.333,0,0,,0,3,3,2,0,0,0,3,2
2006,Joe Smith,PF,30,MIL,5,0,106,16,33,0.485,0,0,,16,33,0.485,0.485,6,9,0.667,6,21,27,3,2,2,1,16,38
2006,Eric Snow,PG,32,CLE,13,13,408,32,76,0.421,0,1,0,32,75,0.427,0.421,22,29,0.759,10,33,43,36,11,3,21,36,86
2006,Jerry Stackhouse,SG,31,DAL,22,1,711,111,276,0.402,22,65,0.338,89,211,0.422,0.442,58,74,0.784,20,42,62,56,12,6,37,43,302
2006,Peja Stojakovic,SF,28,IND,2,2,51,8,18,0.444,0,3,0,8,15,0.533,0.444,6,7,0.857,0,9,9,4,1,1,1,4,22
2006,Mike Sweetney,C,23,CHI,6,6,120,14,34,0.412,0,0,,14,34,0.412,0.412,15,19,0.789,16,17,33,7,3,6,7,24,43
2006,Donell Taylor,SG,23,WAS,1,0,3,0,1,0,0,1,0,0,0,,0,0,0,,0,0,0,1,1,0,0,0,0
2006,Jason Terry,PG,28,DAL,22,22,844,163,369,0.442,31,101,0.307,132,268,0.493,0.484,59,71,0.831,12,52,64,83,26,1,44,55,416
2006,Billy Thomas,SG,30,WAS,3,0,14,0,7,0,0,4,0,0,3,0,0,2,4,0.5,0,1,1,0,0,0,0,3,2
2006,Etan Thomas,C,27,WAS,3,0,18,2,5,0.4,0,0,,2,5,0.4,0.4,2,4,0.5,2,4,6,0,2,2,0,3,6
2006,John Thomas,C,30,NJN,8,0,56,3,6,0.5,0,0,,3,6,0.5,0.5,1,2,0.5,4,6,10,2,3,1,5,15,7
2006,Kenny Thomas,PF,28,SAC,6,6,148,13,24,0.542,0,0,,13,24,0.542,0.542,9,13,0.692,12,15,27,8,5,0,9,22,35
2006,Kurt Thomas,C,33,PHO,1,0,6,0,0,,0,0,,0,0,,,1,2,0.5,0,1,1,0,0,0,0,2,1
2006,Tim Thomas,PF,28,PHO,20,14,636,108,220,0.491,48,108,0.444,60,112,0.536,0.6,38,49,0.776,16,110,126,25,18,8,22,90,302
2006,Jamaal Tinsley,PG,27,IND,1,0,7,1,3,0.333,0,2,0,1,1,1,0.333,0,0,,0,0,0,1,1,0,1,1,2
2006,Jake Tsakalidis,C,26,MEM,4,3,59,6,10,0.6,0,0,,6,10,0.6,0.6,1,2,0.5,4,7,11,2,1,1,7,13,13
2006,Nikoloz Tskitishvili,SF,22,PHO,4,0,8,0,3,0,0,1,0,0,2,0,0,1,2,0.5,0,1,1,2,0,0,1,1,1
2006,Ronny Turiaf,C,23,LAL,3,0,25,3,5,0.6,0,0,,3,5,0.6,0.6,5,6,0.833,4,3,7,0,0,1,2,5,11
2006,Beno Udrih,PG,23,SAS,7,0,47,10,30,0.333,1,6,0.167,9,24,0.375,0.35,4,5,0.8,1,3,4,8,0,0,3,8,25
2006,Nick Van Exel,PG,34,SAS,12,0,133,7,32,0.219,3,10,0.3,4,22,0.182,0.266,9,9,1,1,11,12,17,3,2,5,14,26
2006,Keith Van Horn,SF,30,DAL,14,3,172,20,59,0.339,8,28,0.286,12,31,0.387,0.407,3,3,1,8,24,32,2,0,4,6,24,51
2006,Anderson Varejao,C,23,CLE,13,0,238,31,50,0.62,0,0,,31,50,0.62,0.62,26,37,0.703,18,40,58,3,9,2,6,50,88
2006,Jacque Vaughn,SG,30,NJN,11,0,159,12,33,0.364,0,1,0,12,32,0.375,0.364,4,7,0.571,3,8,11,12,2,0,4,23,28
2006,Sasha Vujacic,PG,21,LAL,7,0,129,11,26,0.423,9,15,0.6,2,11,0.182,0.596,11,11,1,3,14,17,6,4,0,3,14,42
2006,Dwyane Wade,SG,24,MIA,23,23,959,219,441,0.497,14,37,0.378,205,404,0.507,0.512,202,250,0.808,28,107,135,132,51,26,90,71,654
2006,Antoine Walker,PF,29,MIA,23,23,862,114,283,0.403,48,148,0.324,66,135,0.489,0.488,31,54,0.574,16,113,129,56,23,8,47,69,307
2006,Ben Wallace,C,31,DET,18,18,642,33,71,0.465,0,1,0,33,70,0.471,0.465,18,66,0.273,60,129,189,31,24,22,15,41,84
2006,Rasheed Wallace,PF,31,DET,18,18,628,96,223,0.43,32,79,0.405,64,144,0.444,0.502,29,55,0.527,17,97,114,32,10,15,25,65,253
2006,Luke Walton,SF,25,LAL,7,7,235,38,83,0.458,4,11,0.364,34,72,0.472,0.482,5,5,1,10,35,45,12,7,1,11,16,85
2006,Hakim Warrick,PF,23,MEM,3,1,43,4,16,0.25,0,1,0,4,15,0.267,0.25,12,14,0.857,1,6,7,0,1,0,4,7,20
2006,Bonzi Wells,SG,29,SAC,6,6,249,53,87,0.609,5,8,0.625,48,79,0.608,0.638,28,43,0.651,25,47,72,8,5,2,18,25,139
2006,Jiri Welsch,SF,26,MIL,4,0,15,2,4,0.5,0,0,,2,4,0.5,0.5,3,4,0.75,0,3,3,2,1,0,0,1,7
2006,Jason Williams,PG,30,MIA,23,23,686,75,185,0.405,26,95,0.274,49,90,0.544,0.476,38,45,0.844,3,43,46,90,15,0,36,42,214
2006,Mo Williams,PG,23,MIL,5,0,75,17,34,0.5,2,11,0.182,15,23,0.652,0.529,0,0,,0,3,3,10,1,0,6,12,36
2006,Corliss Williamson,SF,32,SAC,3,0,11,2,5,0.4,0,0,,2,5,0.4,0.4,3,3,1,0,1,1,0,0,0,0,3,7
2006,Metta World Peace,SF,26,SAC,5,5,198,31,81,0.383,9,27,0.333,22,54,0.407,0.438,16,23,0.696,8,17,25,15,8,4,5,15,87
2006,Antoine Wright,SG,21,NJN,5,0,10,1,4,0.25,0,0,,1,4,0.25,0.25,2,3,0.667,0,0,0,0,0,0,0,0,4
2006,Lorenzen Wright,C,30,MEM,4,0,86,11,18,0.611,0,0,,11,18,0.611,0.611,7,10,0.7,11,9,20,3,0,4,5,9,29
2007,Hassan Adams,SG,22,NJN,6,0,9,1,2,0.5,0,0,,1,2,0.5,0.5,0,0,,0,1,1,0,0,0,0,3,2
2007,Maurice Ager,SG,22,DAL,3,0,24,5,9,0.556,2,3,0.667,3,6,0.5,0.667,3,6,0.5,1,2,3,0,0,0,0,3,15
2007,Malik Allen,PF,28,CHI,5,0,34,2,12,0.167,0,0,,2,12,0.167,0.167,0,0,,4,3,7,1,1,1,3,7,4
2007,Rafer Alston,PG,30,HOU,7,7,309,25,74,0.338,16,50,0.32,9,24,0.375,0.446,10,13,0.769,6,42,48,35,13,3,17,23,76
2007,Carmelo Anthony,SF,22,DEN,5,5,210,47,98,0.48,9,18,0.5,38,80,0.475,0.526,31,39,0.795,18,25,43,6,5,0,19,12,134
2007,Rafael Araujo,C,26,UTA,5,0,28,3,8,0.375,0,0,,3,8,0.375,0.375,5,12,0.417,3,8,11,1,1,0,0,8,11
2007,Trevor Ariza,SG,21,ORL,4,0,47,5,16,0.313,0,0,,5,16,0.313,0.313,1,4,0.25,5,4,9,5,1,0,4,9,11
2007,Carlos Arroyo,PG,27,ORL,3,0,40,5,14,0.357,0,2,0,5,12,0.417,0.357,2,2,1,2,3,5,6,1,0,1,4,12
2007,Kelenna Azubuike,SG,23,GSW,6,0,15,1,3,0.333,0,1,0,1,2,0.5,0.333,2,2,1,1,3,4,0,1,0,0,1,4
2007,Marcus Banks,PG,25,PHO,2,0,7,0,2,0,0,1,0,0,1,0,0,2,2,1,0,0,0,1,0,0,0,0,2
2007,Leandro Barbosa,SG,24,PHO,11,1,349,64,158,0.405,18,59,0.305,46,99,0.465,0.462,28,39,0.718,7,31,38,24,12,2,22,30,174
2007,J.J. Barea,PG,22,DAL,2,0,4,0,0,,0,0,,0,0,,,0,2,0,0,0,0,0,0,0,0,0,0
2007,Andrea Bargnani,PF,21,TOR,6,3,181,22,46,0.478,7,17,0.412,15,29,0.517,0.554,15,19,0.789,3,21,24,6,5,3,7,16,66
2007,Matt Barnes,PF,26,GSW,11,3,330,45,100,0.45,19,45,0.422,26,55,0.473,0.545,13,18,0.722,26,37,63,26,16,4,20,44,122
2007,Brent Barry,SG,35,SAS,19,0,225,21,60,0.35,15,49,0.306,6,11,0.545,0.475,2,2,1,4,21,25,21,4,2,11,17,59
2007,Tony Battie,PF,30,ORL,4,4,87,7,18,0.389,0,0,,7,18,0.389,0.389,1,4,0.25,3,13,16,1,0,0,0,12,15
2007,Shane Battier,SF,28,HOU,7,7,272,23,51,0.451,19,43,0.442,4,8,0.5,0.637,7,8,0.875,3,15,18,15,12,7,8,20,72
2007,Raja Bell,SG,30,PHO,11,11,438,40,87,0.46,20,45,0.444,20,42,0.476,0.575,12,14,0.857,6,27,33,20,10,2,15,40,112
2007,Andris Biedrins,C,20,GSW,11,8,267,27,37,0.73,0,0,,27,37,0.73,0.73,16,30,0.533,19,50,69,5,8,17,9,29,70
2007,Chauncey Billups,PG,30,DET,16,16,649,84,193,0.435,35,90,0.389,49,103,0.476,0.526,94,113,0.832,7,46,53,91,19,2,46,39,297
2007,Steve Blake,PG,26,DEN,5,5,180,14,31,0.452,8,16,0.5,6,15,0.4,0.581,0,0,,1,11,12,23,3,0,10,8,36
2007,Andray Blatche,PF,20,WAS,2,0,25,4,6,0.667,0,0,,4,6,0.667,0.667,1,1,1,3,4,7,0,0,0,1,2,9
2007,Matt Bonner,PF,26,SAS,9,0,25,2,7,0.286,1,4,0.25,1,3,0.333,0.357,2,2,1,2,1,3,0,2,0,3,6,7
2007,Josh Boone,PF,22,NJN,12,0,118,12,24,0.5,0,0,,12,24,0.5,0.5,12,24,0.5,7,12,19,3,1,3,3,16,36
2007,Calvin Booth,C,30,WAS,1,0,18,2,3,0.667,0,0,,2,3,0.667,0.667,0,0,,2,2,4,1,1,0,1,3,4
2007,Carlos Boozer,PF,25,UTA,17,17,654,162,302,0.536,0,0,,162,302,0.536,0.536,76,103,0.738,54,153,207,50,17,5,51,52,400
2007,Chris Bosh,C,22,TOR,6,6,222,36,91,0.396,1,5,0.2,35,86,0.407,0.401,32,38,0.842,7,47,54,15,5,11,12,19,105
2007,Bruce Bowen,SF,35,SAS,20,20,689,47,119,0.395,33,74,0.446,14,45,0.311,0.534,3,6,0.5,12,69,81,26,28,4,14,54,130
2007,Ronnie Brewer,SG,21,UTA,8,0,41,6,10,0.6,0,0,,6,10,0.6,0.6,7,13,0.538,2,4,6,2,1,0,2,3,19
2007,Dee Brown,PG,22,UTA,8,0,52,6,17,0.353,0,6,0,6,11,0.545,0.353,1,4,0.25,1,2,3,9,0,0,4,1,13
2007,Kwame Brown,C,24,LAL,5,5,133,19,36,0.528,0,0,,19,36,0.528,0.528,5,9,0.556,13,15,28,1,1,4,9,16,43
2007,P.J. Brown,PF,37,CHI,10,10,228,33,67,0.493,0,0,,33,67,0.493,0.493,17,23,0.739,17,30,47,12,8,2,8,29,83
2007,Shannon Brown,SG,21,CLE,1,0,0,0,0,,0,0,,0,0,,,0,0,,0,0,0,0,0,0,0,0,0
2007,Kobe Bryant,SG,28,LAL,5,5,215,60,130,0.462,10,28,0.357,50,102,0.49,0.5,34,37,0.919,1,25,26,22,5,2,22,10,164
2007,Greg Buckner,SG,30,DAL,6,0,44,0,7,0,0,4,0,0,3,0,0,1,2,0.5,2,4,6,2,2,1,2,7,1
2007,Pat Burke,C,33,PHO,3,0,7,1,2,0.5,0,0,,1,2,0.5,0.5,0,0,,0,1,1,0,0,1,0,3,2
2007,Andrew Bynum,C,19,LAL,5,0,55,8,15,0.533,0,0,,8,15,0.533,0.533,4,10,0.4,8,15,23,0,0,2,2,7,20
2007,Jose Calderon,PG,25,TOR,6,1,146,35,69,0.507,3,12,0.25,32,57,0.561,0.529,5,6,0.833,2,8,10,32,5,0,15,12,78
2007,Marcus Camby,C,32,DEN,5,5,184,17,45,0.378,0,0,,17,45,0.378,0.378,4,6,0.667,12,62,74,10,4,16,10,14,38
2007,Anthony Carter,PG,31,DEN,1,0,14,4,4,1,0,0,,4,4,1,1,0,1,0,0,1,1,2,0,0,1,2,8
2007,Vince Carter,SG,30,NJN,12,12,487,93,235,0.396,21,54,0.389,72,181,0.398,0.44,61,88,0.693,17,65,82,64,11,7,38,35,268
2007,Jarron Collins,C,28,UTA,13,0,110,3,9,0.333,0,0,,3,9,0.333,0.333,9,17,0.529,8,12,20,5,4,0,1,21,15
2007,Jason Collins,PF,28,NJN,12,12,329,12,21,0.571,0,0,,12,21,0.571,0.571,4,11,0.364,16,24,40,2,7,3,16,45,28
2007,Brian Cook,PF,26,LAL,5,0,51,6,18,0.333,3,7,0.429,3,11,0.273,0.417,3,3,1,2,4,6,0,0,1,2,13,18
2007,Austin Croshere,PF,31,DAL,3,0,34,4,12,0.333,3,4,0.75,1,8,0.125,0.458,4,4,1,3,3,6,0,0,0,2,5,15
2007,Erick Dampier,C,31,DAL,5,2,38,2,3,0.667,0,0,,2,3,0.667,0.667,1,2,0.5,9,8,17,1,0,0,4,9,5
2007,Antonio Daniels,SG,31,WAS,4,4,176,17,38,0.447,1,5,0.2,16,33,0.485,0.461,18,21,0.857,2,16,18,47,5,1,7,4,53
2007,Baron Davis,PG,27,GSW,11,11,445,98,191,0.513,25,67,0.373,73,124,0.589,0.579,57,74,0.77,11,39,50,72,32,7,32,46,278
2007,Dale Davis,C,37,DET,8,0,51,3,8,0.375,0,0,,3,8,0.375,0.375,2,4,0.5,5,7,12,1,2,2,2,14,8
2007,Carlos Delfino,SG,24,DET,16,0,135,15,37,0.405,3,16,0.188,12,21,0.571,0.446,4,6,0.667,6,15,21,8,5,1,7,13,37
2007,Luol Deng,SF,21,CHI,10,10,410,88,168,0.524,0,1,0,88,167,0.527,0.524,46,57,0.807,30,57,87,24,10,7,23,22,222
2007,Boris Diaw,PF,24,PHO,10,0,235,28,59,0.475,0,6,0,28,53,0.528,0.475,10,15,0.667,13,19,32,30,7,2,17,18,66
2007,Yakhouba Diawara,SG,24,DEN,1,0,1,0,0,,0,0,,0,0,,,0,0,,0,0,0,0,0,0,0,0,0
2007,DeSagana Diop,C,25,DAL,6,3,140,9,15,0.6,0,0,,9,15,0.6,0.6,3,7,0.429,16,25,41,2,3,10,4,21,21
2007,Juan Dixon,SG,28,TOR,6,0,63,8,21,0.381,2,8,0.25,6,13,0.462,0.429,0,0,,0,4,4,3,7,0,10,6,18
2007,Michael Doleac,C,29,MIA,1,0,1,0,0,,0,0,,0,0,,,0,0,,0,0,0,0,0,0,0,0,0
2007,Keyon Dooling,SG,26,ORL,4,0,65,12,25,0.48,1,3,0.333,11,22,0.5,0.5,4,6,0.667,1,6,7,5,2,1,2,7,29
2007,Chris Duhon,PG,24,CHI,9,0,172,9,31,0.29,6,19,0.316,3,12,0.25,0.387,8,10,0.8,3,13,16,21,3,1,7,12,32
2007,Tim Duncan,C,30,SAS,20,20,736,174,334,0.521,0,0,,174,334,0.521,0.521,96,149,0.644,73,156,229,65,13,62,59,59,444
2007,Monta Ellis,SG,21,GSW,11,6,238,32,82,0.39,1,9,0.111,31,73,0.425,0.396,23,28,0.821,8,17,25,10,10,2,20,23,88
2007,Francisco Elson,C,30,SAS,20,8,230,26,44,0.591,0,1,0,26,43,0.605,0.591,14,20,0.7,22,40,62,2,8,6,19,41,66
2007,Maurice Evans,SG,28,LAL,5,0,82,10,26,0.385,5,13,0.385,5,13,0.385,0.481,0,0,,3,5,8,3,2,0,0,4,25
2007,Jordan Farmar,PG,20,LAL,5,5,114,12,28,0.429,2,10,0.2,10,18,0.556,0.464,6,7,0.857,1,13,14,8,6,1,5,9,32
2007,Michael Finley,SF,33,SAS,20,20,538,73,178,0.41,44,105,0.419,29,73,0.397,0.534,35,39,0.897,8,50,58,22,11,4,13,28,225
2007,Derek Fisher,SG,32,UTA,16,14,445,49,121,0.405,12,32,0.375,37,89,0.416,0.455,42,45,0.933,4,21,25,42,16,2,19,51,152
2007,T.J. Ford,PG,23,TOR,6,5,136,37,76,0.487,5,10,0.5,32,66,0.485,0.52,17,21,0.81,5,5,10,24,7,2,14,7,96
2007,Adonal Foyle,C,31,GSW,3,0,6,1,1,1,0,0,,1,1,1,1,0,0,,0,2,2,0,0,0,0,0,2
2007,Devean George,SF,29,DAL,6,1,109,5,25,0.2,3,12,0.25,2,13,0.154,0.26,8,10,0.8,4,14,18,4,6,2,7,12,21
2007,Daniel Gibson,PG,20,CLE,20,2,402,50,116,0.431,27,66,0.409,23,50,0.46,0.547,38,43,0.884,9,23,32,21,12,4,9,34,165
2007,Manu Ginobili,SG,29,SAS,20,0,602,99,247,0.401,38,99,0.384,61,148,0.412,0.478,97,116,0.836,16,93,109,74,33,4,42,61,333
2007,Gordan Giricek,SG,29,UTA,17,3,307,38,91,0.418,14,26,0.538,24,65,0.369,0.495,14,16,0.875,4,24,28,17,3,2,22,37,104
2007,Drew Gooden,PF,25,CLE,20,20,605,99,201,0.493,0,2,0,99,199,0.497,0.493,30,39,0.769,49,111,160,20,10,9,27,62,228
2007,Ben Gordon,SG,23,CHI,10,10,395,61,147,0.415,24,55,0.436,37,92,0.402,0.497,58,63,0.921,9,29,38,38,9,1,34,34,204
2007,Joey Graham,SF,24,TOR,6,3,109,6,21,0.286,0,1,0,6,20,0.3,0.286,4,5,0.8,1,19,20,2,4,0,6,12,16
2007,Adrian Griffin,SF,32,CHI,4,0,9,0,6,0,0,0,,0,6,0,0,0,0,,1,0,1,0,1,0,0,1,0
2007,Richard Hamilton,SG,28,DET,16,16,638,108,252,0.429,8,20,0.4,100,232,0.431,0.444,77,89,0.865,32,37,69,60,14,2,31,60,301
2007,Matt Harpring,SF,30,UTA,17,0,433,62,136,0.456,0,4,0,62,132,0.47,0.456,34,47,0.723,33,49,82,23,7,3,22,41,158
2007,Al Harrington,PF,26,GSW,11,5,262,39,98,0.398,15,38,0.395,24,60,0.4,0.474,19,30,0.633,17,34,51,6,5,7,10,40,112
2007,Devin Harris,PG,23,DAL,6,6,163,31,63,0.492,3,10,0.3,28,53,0.528,0.516,14,19,0.737,1,11,12,30,6,1,9,23,79
2007,Udonis Haslem,PF,26,MIA,4,4,103,12,25,0.48,0,0,,12,25,0.48,0.48,6,8,0.75,4,17,21,4,1,2,2,14,30
2007,Chuck Hayes,PF,23,HOU,7,7,197,12,17,0.706,0,1,0,12,16,0.75,0.706,2,5,0.4,14,31,45,3,9,3,7,22,26
2007,Jarvis Hayes,SF,25,WAS,4,4,139,15,46,0.326,7,19,0.368,8,27,0.296,0.402,6,7,0.857,4,10,14,4,2,1,0,12,43
2007,Brendan Haywood,C,27,WAS,3,0,34,5,7,0.714,0,0,,5,7,0.714,0.714,3,4,0.75,3,2,5,1,1,0,1,7,13
2007,Luther Head,SG,24,HOU,7,0,141,11,36,0.306,6,23,0.261,5,13,0.385,0.389,4,8,0.5,2,17,19,8,3,2,7,16,32
2007,Nene Hilario,C,24,DEN,5,5,179,31,53,0.585,0,0,,31,53,0.585,0.585,14,18,0.778,22,17,39,12,3,3,13,21,76
2007,Grant Hill*,SG,34,ORL,4,4,143,19,38,0.5,0,0,,19,38,0.5,0.5,22,33,0.667,2,20,22,15,2,1,10,8,60
2007,Kirk Hinrich,PG,26,CHI,10,10,362,44,117,0.376,13,43,0.302,31,74,0.419,0.432,20,26,0.769,4,38,42,75,9,3,23,37,121
2007,Robert Horry,PF,36,SAS,18,0,361,25,60,0.417,13,37,0.351,12,23,0.522,0.525,14,17,0.824,16,54,70,29,11,24,14,30,77
2007,Eddie House,SG,28,NJN,4,0,18,2,8,0.25,1,6,0.167,1,2,0.5,0.313,0,0,,0,2,2,1,1,0,2,2,5
2007,Dwight Howard,C,21,ORL,4,4,167,23,42,0.548,0,0,,23,42,0.548,0.548,15,33,0.455,16,43,59,7,2,4,17,13,61
2007,Josh Howard,SF,26,DAL,6,6,248,51,99,0.515,7,18,0.389,44,81,0.543,0.551,19,27,0.704,15,44,59,17,13,5,12,22,128
2007,Juwan Howard,PF,33,HOU,7,0,157,14,35,0.4,0,0,,14,35,0.4,0.4,7,11,0.636,10,21,31,7,5,0,4,10,35
2007,Larry Hughes,SG,28,CLE,18,18,639,69,199,0.347,19,54,0.352,50,145,0.345,0.394,47,63,0.746,9,62,71,44,25,8,42,35,204
2007,Kris Humphries,PF,21,TOR,6,0,69,3,9,0.333,0,0,,3,9,0.333,0.333,3,8,0.375,7,10,17,1,1,2,3,11,9
2007,Lindsey Hunter,PG,36,DET,13,0,133,7,31,0.226,4,18,0.222,3,13,0.231,0.29,5,5,1,2,8,10,16,6,1,10,22,23
2007,Zydrunas Ilgauskas,C,31,CLE,20,20,649,97,197,0.492,0,0,,97,197,0.492,0.492,57,68,0.838,66,127,193,17,9,16,32,60,251
2007,Allen Iverson*,SG,31,DEN,5,5,223,42,114,0.368,5,17,0.294,37,97,0.381,0.39,25,31,0.806,0,3,3,29,7,0,15,11,114
2007,Luke Jackson,SF,25,TOR,3,0,11,0,0,,0,0,,0,0,,,6,6,1,1,4,5,1,1,0,1,3,6
2007,Stephen Jackson,SF,28,GSW,11,11,454,61,161,0.379,26,72,0.361,35,89,0.393,0.46,71,87,0.816,6,34,40,40,22,8,41,39,219
2007,LeBron James,SF,22,CLE,20,20,893,166,399,0.416,21,75,0.28,145,324,0.448,0.442,148,196,0.755,26,135,161,159,34,10,66,40,501
2007,Antawn Jamison,PF,30,WAS,4,4,173,49,103,0.476,9,26,0.346,40,77,0.519,0.519,21,28,0.75,13,26,39,5,2,4,7,13,128
2007,Sarunas Jasikevicius,PG,30,GSW,4,0,6,0,1,0,0,0,,0,1,0,0,1,2,0.5,0,0,0,2,0,0,0,1,1
2007,Richard Jefferson,SF,26,NJN,12,12,489,81,168,0.482,13,40,0.325,68,128,0.531,0.521,61,66,0.924,4,63,67,27,9,5,27,24,236
2007,Damon Jones,PG,30,CLE,11,0,139,8,26,0.308,7,22,0.318,1,4,0.25,0.442,3,3,1,1,8,9,11,0,0,0,10,26
2007,Eddie Jones,SG,35,MIA,3,2,66,2,9,0.222,1,6,0.167,1,3,0.333,0.278,5,6,0.833,1,5,6,5,1,1,1,7,10
2007,James Jones,SF,26,PHO,11,6,171,19,36,0.528,8,18,0.444,11,18,0.611,0.639,9,11,0.818,3,12,15,3,2,2,4,11,55
2007,Jason Kapono,SF,25,MIA,4,1,77,8,17,0.471,2,4,0.5,6,13,0.462,0.529,2,2,1,0,5,5,2,2,0,1,9,20
2007,Jason Kidd*,PG,33,NJN,12,12,484,64,148,0.432,34,81,0.42,30,67,0.448,0.547,13,25,0.52,23,108,131,131,22,5,41,31,175
2007,Andrei Kirilenko,SF,25,UTA,17,17,527,55,123,0.447,3,9,0.333,52,114,0.456,0.459,51,65,0.785,28,61,89,44,15,40,35,52,164
2007,Linas Kleiza,PF,22,DEN,5,0,66,3,13,0.231,1,6,0.167,2,7,0.286,0.269,1,2,0.5,0,8,8,2,0,0,0,6,8
2007,John Lucas III,PG,24,HOU,2,0,8,0,1,0,0,1,0,0,0,,0,0,0,,0,0,0,0,1,0,2,0,0
2007,Shawn Marion,SF,28,PHO,11,11,455,76,152,0.5,12,34,0.353,64,118,0.542,0.539,22,33,0.667,27,87,114,13,16,19,12,27,186
2007,Donyell Marshall,PF,33,CLE,19,0,204,23,69,0.333,14,45,0.311,9,24,0.375,0.435,7,11,0.636,12,29,41,5,3,4,5,30,67
2007,Darrick Martin,PG,35,TOR,2,0,8,0,2,0,0,2,0,0,0,,0,2,2,1,0,1,1,2,0,0,0,0,2
2007,Roger Mason,SG,26,WAS,4,0,56,7,16,0.438,5,10,0.5,2,6,0.333,0.594,5,6,0.833,0,2,2,1,1,0,3,10,24
2007,Jason Maxiell,C,23,DET,14,0,146,22,33,0.667,0,1,0,22,32,0.688,0.667,12,23,0.522,11,22,33,2,4,9,7,21,56
2007,Antonio McDyess,PF,32,DET,16,0,354,37,106,0.349,0,2,0,37,104,0.356,0.349,19,26,0.731,41,72,113,18,11,15,17,55,93
2007,Tracy McGrady*,SG,27,HOU,7,7,280,63,160,0.394,9,36,0.25,54,124,0.435,0.422,42,57,0.737,5,36,41,51,5,6,21,12,177
2007,C.J. Miles,SG,19,UTA,1,0,3,0,0,,0,0,,0,0,,,1,2,0.5,0,0,0,0,0,0,0,0,1
2007,Darko Milicic,PF,21,ORL,4,0,115,20,34,0.588,0,0,,20,34,0.588,0.588,9,17,0.529,10,8,18,4,1,4,2,9,49
2007,Paul Millsap,PF,21,UTA,17,0,263,42,80,0.525,0,1,0,42,79,0.532,0.525,16,24,0.667,38,37,75,8,11,9,13,39,100
2007,Yao Ming*,C,26,HOU,7,7,260,55,125,0.44,0,0,,55,125,0.44,0.44,66,75,0.88,23,49,72,6,1,5,33,27,176
2007,Nazr Mohammed,C,29,DET,2,0,6,1,2,0.5,0,0,,1,2,0.5,0.5,3,3,1,1,2,3,0,0,0,0,1,5
2007,Mikki Moore,C,31,NJN,12,12,399,56,100,0.56,0,0,,56,100,0.56,0.56,23,29,0.793,23,44,67,14,10,7,20,47,135
2007,Alonzo Mourning*,C,36,MIA,4,0,55,10,11,0.909,0,0,,10,11,0.909,0.909,5,13,0.385,1,7,8,1,0,3,1,6,25
2007,Ronald Murray,SG,27,DET,12,0,136,11,31,0.355,0,2,0,11,29,0.379,0.355,8,11,0.727,2,7,9,14,4,1,8,12,30
2007,Dikembe Mutombo*,C,40,HOU,7,0,40,3,3,1,0,0,,3,3,1,1,3,3,1,5,6,11,1,0,3,0,5,9
2007,Bostjan Nachbar,SF,26,NJN,12,0,281,40,95,0.421,18,48,0.375,22,47,0.468,0.516,21,22,0.955,5,30,35,18,7,1,18,30,119
2007,Eduardo Najera,PF,30,DEN,5,0,96,4,17,0.235,0,3,0,4,14,0.286,0.235,1,2,0.5,11,17,28,2,2,1,2,10,9
2007,Steve Nash*,PG,32,PHO,11,11,413,74,160,0.463,19,39,0.487,55,121,0.455,0.522,41,46,0.891,4,31,35,146,4,1,48,21,208
2007,Jameer Nelson,PG,24,ORL,4,4,129,21,50,0.42,5,14,0.357,16,36,0.444,0.47,10,11,0.909,4,8,12,13,3,0,9,19,57
2007,Rasho Nesterovic,C,30,TOR,5,4,71,7,15,0.467,0,0,,7,15,0.467,0.467,3,3,1,10,13,23,3,0,2,4,4,17
2007,Ira Newble,SF,32,CLE,6,0,10,0,2,0,0,2,0,0,0,,0,0,0,,0,1,1,1,0,0,0,3,0
2007,Andres Nocioni,PF,27,CHI,10,0,197,31,86,0.36,13,39,0.333,18,47,0.383,0.436,13,18,0.722,3,32,35,8,2,5,13,25,88
2007,Dirk Nowitzki,PF,28,DAL,6,6,239,36,94,0.383,4,19,0.211,32,75,0.427,0.404,42,50,0.84,25,43,68,14,11,8,14,20,118
2007,Shaquille O'Neal*,C,34,MIA,4,4,121,33,59,0.559,0,0,,33,59,0.559,0.559,9,27,0.333,16,18,34,5,1,6,14,15,75
2007,Fabricio Oberto,PF,31,SAS,20,12,415,50,80,0.625,0,1,0,50,79,0.633,0.625,12,21,0.571,41,57,98,14,6,4,10,54,112
2007,Lamar Odom,PF,27,LAL,5,5,192,41,85,0.482,3,11,0.273,38,74,0.514,0.5,12,24,0.5,20,45,65,11,2,6,10,17,97
2007,Mehmet Okur,C,27,UTA,17,17,585,71,183,0.388,25,79,0.316,46,104,0.442,0.456,33,42,0.786,37,95,132,30,24,16,24,65,200
2007,Anthony Parker,SG,31,TOR,6,6,240,26,62,0.419,8,20,0.4,18,42,0.429,0.484,31,39,0.795,3,29,32,6,9,2,7,18,91
2007,Smush Parker,PG,25,LAL,5,0,59,2,13,0.154,1,6,0.167,1,7,0.143,0.192,4,4,1,4,3,7,3,3,1,3,8,9
2007,Tony Parker,PG,24,SAS,20,20,751,168,350,0.48,7,21,0.333,161,329,0.489,0.49,72,106,0.679,14,53,67,115,22,0,66,34,415
2007,Sasha Pavlovic,SG,23,CLE,20,20,616,72,189,0.381,20,58,0.345,52,131,0.397,0.434,19,36,0.528,13,38,51,32,19,5,36,64,183
2007,Gary Payton*,PG,38,MIA,2,0,32,0,3,0,0,1,0,0,2,0,0,0,0,,0,4,4,3,0,0,4,3,0
2007,Morris Peterson,SF,29,TOR,6,2,183,15,29,0.517,6,12,0.5,9,17,0.529,0.621,5,6,0.833,5,22,27,2,2,2,6,20,41
2007,Eric Piatkowski,SG,36,PHO,1,0,3,1,1,1,0,0,,1,1,1,1,0,0,,0,0,0,0,0,0,0,0,2
2007,Mickael Pietrus,SF,24,GSW,11,0,209,17,49,0.347,7,27,0.259,10,22,0.455,0.418,25,36,0.694,13,29,42,6,5,9,7,32,66
2007,Scot Pollard,C,31,CLE,3,0,3,0,0,,0,0,,0,0,,,0,0,,0,0,0,0,0,0,0,1,0
2007,James Posey,SF,30,MIA,4,1,139,10,26,0.385,6,19,0.316,4,7,0.571,0.5,5,5,1,1,30,31,6,8,5,5,18,31
2007,Josh Powell,PF,24,GSW,4,0,6,0,0,,0,0,,0,0,,,1,2,0.5,1,0,1,0,0,1,0,0,1
2007,Tayshaun Prince,SF,26,DET,16,16,665,83,200,0.415,18,44,0.409,65,156,0.417,0.46,41,54,0.759,27,76,103,60,15,5,30,30,225
2007,J.J. Redick,PG,22,ORL,1,0,11,1,2,0.5,1,1,1,0,1,0,0.75,0,0,,0,0,0,2,0,0,1,2,3
2007,Jason Richardson,SG,26,GSW,11,11,428,81,170,0.476,29,82,0.354,52,88,0.591,0.562,19,27,0.704,24,50,74,22,14,5,24,38,210
2007,Bernard Robinson,SF,26,NJN,1,0,6,0,1,0,0,0,,0,1,0,0,0,0,,0,1,1,2,1,0,1,2,0
2007,Clifford Robinson,C,40,NJN,4,0,20,1,6,0.167,1,2,0.5,0,4,0,0.25,0,0,,0,0,0,0,1,0,1,1,3
2007,Jalen Rose,SF,34,PHO,1,0,9,1,4,0.25,0,1,0,1,3,0.333,0.25,0,0,,0,1,1,2,0,0,0,2,2
2007,Michael Ruffin,PF,30,WAS,4,0,28,1,3,0.333,0,1,0,1,2,0.5,0.333,0,0,,5,4,9,0,3,0,0,2,2
2007,Thabo Sefolosha,SG,22,CHI,9,0,99,10,26,0.385,3,8,0.375,7,18,0.389,0.442,7,12,0.583,4,13,17,7,2,0,7,11,30
2007,J.R. Smith,SG,21,DEN,4,0,47,6,22,0.273,0,12,0,6,10,0.6,0.273,6,6,1,1,8,9,2,4,1,3,6,18
2007,Eric Snow,PG,33,CLE,19,0,244,12,38,0.316,0,3,0,12,35,0.343,0.316,8,14,0.571,7,21,28,29,11,2,8,22,32
2007,Kirk Snyder,SF,23,HOU,3,0,9,1,3,0.333,0,2,0,1,1,1,0.333,0,0,,0,1,1,0,0,0,1,0,2
2007,Darius Songaila,PF,28,WAS,4,0,90,20,41,0.488,0,2,0,20,39,0.513,0.488,3,3,1,5,8,13,4,3,0,4,17,43
2007,Vassilis Spanoulis,SG,24,HOU,1,0,3,1,2,0.5,0,0,,1,2,0.5,0.5,2,2,1,0,1,1,1,0,0,0,0,4
2007,Jerry Stackhouse,SF,32,DAL,6,0,169,23,66,0.348,11,31,0.355,12,35,0.343,0.432,29,33,0.879,5,17,22,15,4,1,18,9,86
2007,DeShawn Stevenson,SG,25,WAS,4,4,122,9,46,0.196,3,19,0.158,6,27,0.222,0.228,3,7,0.429,2,8,10,7,2,3,3,4,24
2007,Amar'e Stoudemire,C,24,PHO,10,10,343,91,174,0.523,1,3,0.333,90,171,0.526,0.526,70,91,0.769,30,91,121,6,13,19,19,39,253
2007,Mike Sweetney,C,24,CHI,1,0,3,1,2,0.5,0,0,,1,2,0.5,0.5,0,2,0,0,0,0,0,0,0,0,1,2
2007,Donell Taylor,SG,24,WAS,2,0,17,1,6,0.167,0,0,,1,6,0.167,0.167,1,1,1,0,3,3,4,0,0,2,2,3
2007,Jason Terry,SG,29,DAL,6,6,229,39,92,0.424,9,32,0.281,30,60,0.5,0.473,15,18,0.833,3,11,14,22,5,2,17,12,102
2007,Etan Thomas,C,28,WAS,4,4,84,7,17,0.412,0,0,,7,17,0.412,0.412,6,9,0.667,2,20,22,1,2,3,6,9,20
2007,Kurt Thomas,C,34,PHO,11,5,212,34,65,0.523,0,0,,34,65,0.523,0.523,15,17,0.882,11,43,54,12,6,9,9,25,83
2007,Tyrus Thomas,PF,20,CHI,10,0,122,16,41,0.39,0,0,,16,41,0.39,0.39,19,30,0.633,12,22,34,6,10,5,15,23,51
2007,Jake Tsakalidis,C,27,HOU,1,0,3,0,0,,0,0,,0,0,,,2,2,1,1,3,4,0,0,0,0,0,2
2007,Ronny Turiaf,C,24,LAL,4,0,48,5,14,0.357,0,0,,5,14,0.357,0.357,7,10,0.7,6,6,12,1,2,1,1,8,17
2007,Hedo Turkoglu,SF,27,ORL,4,4,156,25,50,0.5,3,9,0.333,22,41,0.537,0.53,2,4,0.5,2,11,13,14,5,4,10,14,55
2007,Beno Udrih,PG,24,SAS,8,0,20,0,6,0,0,2,0,0,4,0,0,2,2,1,1,0,1,1,0,0,3,2,2
2007,Anderson Varejao,C,24,CLE,20,0,447,46,90,0.511,0,4,0,46,86,0.535,0.511,27,48,0.563,46,73,119,11,21,11,20,53,119
2007,Jacque Vaughn,PG,31,SAS,20,0,208,20,50,0.4,0,0,,20,50,0.4,0.4,3,6,0.5,1,8,9,28,4,0,11,24,43
2007,Sasha Vujacic,SG,22,LAL,4,0,43,5,9,0.556,1,4,0.25,4,5,0.8,0.611,0,0,,2,2,4,3,1,0,3,4,11
2007,Dwyane Wade,SG,25,MIA,4,4,162,36,84,0.429,0,5,0,36,79,0.456,0.429,22,32,0.688,7,12,19,25,5,2,23,13,94
2007,Antoine Walker,PF,30,MIA,4,0,92,15,37,0.405,8,16,0.5,7,21,0.333,0.514,9,11,0.818,2,7,9,6,2,1,4,11,47
2007,Ben Wallace,C,32,CHI,10,10,369,30,53,0.566,0,1,0,30,52,0.577,0.566,27,54,0.5,29,66,95,14,15,17,10,19,87
2007,Rasheed Wallace,C,32,DET,16,16,573,86,197,0.437,25,72,0.347,61,125,0.488,0.5,32,38,0.842,19,104,123,28,19,28,19,64,229
2007,Luke Walton,SF,26,LAL,5,5,128,14,36,0.389,5,12,0.417,9,24,0.375,0.458,3,4,0.75,9,12,21,13,7,1,15,13,36
2007,Chris Webber,PF,33,DET,16,16,404,66,126,0.524,0,1,0,66,125,0.528,0.524,26,49,0.531,36,64,100,24,14,9,25,51,158
2007,Deron Williams,PG,22,UTA,17,17,657,122,270,0.452,19,57,0.333,103,213,0.484,0.487,64,81,0.79,9,64,73,146,26,4,68,49,327
2007,Jason Williams,PG,31,MIA,4,4,112,7,28,0.25,5,17,0.294,2,11,0.182,0.339,4,5,0.8,0,8,8,14,5,1,3,5,23
2007,Marcus Williams,PG,21,NJN,12,0,78,12,36,0.333,1,13,0.077,11,23,0.478,0.347,4,5,0.8,3,7,10,13,1,0,12,4,29
2007,Shammond Williams,PG,31,LAL,4,0,80,8,20,0.4,2,8,0.25,6,12,0.5,0.45,0,0,,2,1,3,7,0,1,2,6,18
2007,Antoine Wright,SG,22,NJN,12,0,163,17,36,0.472,3,6,0.5,14,30,0.467,0.514,9,10,0.9,5,18,23,1,5,4,5,14,46
2007,Dorell Wright,SF,21,MIA,1,0,1,0,0,,0,0,,0,0,,,0,0,,0,0,0,0,0,0,0,0,0
2008,Arron Afflalo,SG,22,DET,12,0,84,7,18,0.389,0,2,0,7,16,0.438,0.389,0,0,0,0,5,5,6,4,0,1,5,14
2008,Malik Allen,PF,29,DAL,3,0,18,0,1,0,0,0,0,0,1,0,0,0,0,0,0,0,0,0,0,0,0,4,0
2008,Ray Allen*,SG,32,BOS,26,26,987,133,311,0.428,55,139,0.396,78,172,0.453,0.516,84,92,0.913,25,73,98,71,24,8,38,63,405
2008,Tony Allen,SG,26,BOS,15,0,65,9,16,0.563,0,1,0,9,15,0.6,0.563,2,5,0.4,1,2,3,3,2,0,1,5,20
2008,Rafer Alston,PG,31,HOU,4,4,126,21,48,0.438,11,25,0.44,10,23,0.435,0.552,4,5,0.8,2,4,6,18,4,0,6,7,57
2008,Lou Amundson,PF,25,PHI,2,0,10,2,4,0.5,0,0,0,2,4,0.5,0.5,1,2,0.5,5,2,7,0,0,0,0,2,5
2008,Carmelo Anthony,SF,23,DEN,4,4,146,32,88,0.364,2,8,0.25,30,80,0.375,0.375,24,29,0.828,19,19,38,8,2,1,12,17,90
2008,Gilbert Arenas,PG,26,WAS,4,2,94,14,36,0.389,5,12,0.417,9,24,0.375,0.458,10,12,0.833,0,7,7,11,2,0,8,13,43
2008,Trevor Ariza,SF,22,LAL,8,0,45,7,12,0.583,1,4,0.25,6,8,0.75,0.625,2,4,0.5,3,8,11,1,1,1,1,7,17
2008,Hilton Armstrong,C,23,NOH,8,0,72,8,13,0.615,0,0,0,8,13,0.615,0.615,5,10,0.5,9,11,20,0,0,6,4,12,21
2008,Carlos Arroyo,PG,28,ORL,4,0,30,2,4,0.5,0,1,0,2,3,0.667,0.5,2,2,1,0,2,2,4,0,0,3,4,6
2008,Chucky Atkins,SG,33,DEN,1,0,3,0,1,0,0,1,0,0,0,0,0,0,0,0,0,1,1,0,0,0,0,0,0
2008,James Augustine,PF,23,ORL,1,0,2,1,1,1,0,0,0,1,1,1,1,0,0,0,0,1,1,0,0,0,0,0,2
2008,Leandro Barbosa,SG,25,PHO,5,1,143,19,55,0.345,4,18,0.222,15,37,0.405,0.382,10,11,0.909,2,18,20,9,3,0,4,10,52
2008,J.J. Barea,PG,23,DAL,1,0,5,3,4,0.75,2,2,1,1,2,0.5,1,0,0,0,0,0,0,1,0,0,0,1,8
2008,Andrea Bargnani,PF,22,TOR,5,5,104,13,39,0.333,4,16,0.25,9,23,0.391,0.385,2,2,1,1,6,7,2,4,3,2,15,32
2008,Brent Barry,SF,36,SAS,16,0,227,26,53,0.491,19,41,0.463,7,12,0.583,0.67,12,15,0.8,2,16,18,17,6,2,9,22,83
2008,Brandon Bass,C,22,DAL,5,0,133,17,36,0.472,0,1,0,17,35,0.486,0.472,24,25,0.96,20,14,34,2,3,3,3,12,58
2008,Maceo Baston,PF,32,TOR,1,0,1,0,0,,0,0,0,0,0,0,,0,0,0,0,0,0,0,1,0,0,0,0
2008,Shane Battier,SF,29,HOU,6,6,246,20,45,0.444,12,25,0.48,8,20,0.4,0.578,8,11,0.727,7,16,23,3,6,5,8,19,60
2008,Raja Bell,SG,31,PHO,5,5,215,21,37,0.568,13,20,0.65,8,17,0.471,0.743,13,16,0.813,6,22,28,11,2,1,5,19,68
2008,Mike Bibby,PG,29,ATL,7,7,252,22,65,0.338,7,24,0.292,15,41,0.366,0.392,21,32,0.656,3,19,22,22,4,2,13,12,72
2008,Chauncey Billups,PG,31,DET,15,15,480,69,172,0.401,24,64,0.375,45,108,0.417,0.471,79,95,0.832,6,38,44,83,12,1,20,32,241
2008,Andray Blatche,PF,21,WAS,6,0,89,9,21,0.429,0,1,0,9,20,0.45,0.429,4,12,0.333,7,13,20,1,2,6,5,15,22
2008,Keith Bogans,SG,27,ORL,10,0,293,25,68,0.368,15,45,0.333,10,23,0.435,0.478,8,11,0.727,4,38,42,11,4,0,7,26,73
2008,Matt Bonner,PF,27,SAS,2,0,9,2,3,0.667,0,0,0,2,3,0.667,0.667,0,0,0,0,2,2,2,0,0,0,0,4
2008,Carlos Boozer,PF,26,UTA,12,12,441,76,183,0.415,0,0,0,76,183,0.415,0.415,40,56,0.714,42,105,147,34,6,2,36,47,192
2008,Chris Bosh,C,23,TOR,5,5,199,42,89,0.472,1,7,0.143,41,82,0.5,0.478,35,42,0.833,20,25,45,18,8,2,13,19,120
2008,Bruce Bowen,SF,36,SAS,17,17,508,37,93,0.398,22,54,0.407,15,39,0.385,0.516,8,11,0.727,2,31,33,23,11,6,9,41,104
2008,Ryan Bowen,SF,32,NOH,9,0,39,1,6,0.167,0,1,0,1,5,0.2,0.167,2,2,1,3,11,14,2,1,0,1,1,4
2008,Ronnie Brewer,SG,22,UTA,12,12,305,51,98,0.52,1,6,0.167,50,92,0.543,0.526,19,25,0.76,17,21,38,19,12,4,4,29,122
2008,Aaron Brooks,PG,23,HOU,6,0,50,8,25,0.32,0,10,0,8,15,0.533,0.32,9,11,0.818,0,6,6,3,0,0,3,11,25
2008,Devin Brown,SG,29,CLE,8,0,92,9,34,0.265,5,17,0.294,4,17,0.235,0.338,10,15,0.667,8,11,19,9,2,0,9,10,33
2008,P.J. Brown,PF,38,BOS,25,0,341,26,56,0.464,0,1,0,26,55,0.473,0.464,21,25,0.84,18,41,59,12,5,10,12,58,73
2008,Kobe Bryant,SG,29,LAL,21,21,863,222,463,0.479,32,106,0.302,190,357,0.532,0.514,157,194,0.809,18,101,119,117,35,8,70,59,633
2008,Caron Butler,SF,27,WAS,6,6,246,40,87,0.46,5,21,0.238,35,66,0.53,0.489,27,31,0.871,10,24,34,23,11,1,16,19,112
2008,Jose Calderon,PG,26,TOR,5,0,120,22,50,0.44,10,21,0.476,12,29,0.414,0.54,5,5,1,4,14,18,35,1,0,6,15,59
2008,Marcus Camby,C,33,DEN,4,4,124,5,21,0.238,1,1,1,4,20,0.2,0.262,2,6,0.333,11,42,53,12,4,12,10,10,13
2008,Rodney Carney,SF,23,PHI,6,0,84,12,31,0.387,5,10,0.5,7,21,0.333,0.468,1,2,0.5,3,4,7,5,7,2,0,9,30
2008,Anthony Carter,PG,32,DEN,4,1,61,4,14,0.286,0,5,0,4,9,0.444,0.286,0,0,0,2,8,10,14,1,1,3,6,8
2008,Sam Cassell,PG,38,BOS,21,0,264,37,111,0.333,6,28,0.214,31,83,0.373,0.36,14,17,0.824,2,13,15,25,8,1,12,30,94
2008,Tyson Chandler,C,25,NOH,12,12,412,43,68,0.632,0,0,0,43,68,0.632,0.632,10,16,0.625,45,78,123,5,5,20,10,43,96
2008,Josh Childress,SF,24,ATL,7,0,205,22,42,0.524,0,2,0,22,40,0.55,0.524,6,12,0.5,15,25,40,11,1,5,2,7,50
2008,Jarron Collins,C,29,UTA,5,0,20,0,3,0,0,0,0,0,3,0,0,0,0,0,3,3,6,1,1,1,0,2,0
2008,Samuel Dalembert,C,26,PHI,6,6,193,19,45,0.422,0,0,0,19,45,0.422,0.422,16,19,0.842,20,37,57,3,2,10,10,17,54
2008,Erick Dampier,C,32,DAL,5,5,95,7,17,0.412,0,0,0,7,17,0.412,0.412,4,10,0.4,12,9,21,0,1,3,3,15,18
2008,Antonio Daniels,PG,32,WAS,6,4,154,14,31,0.452,1,4,0.25,13,27,0.481,0.468,15,17,0.882,1,13,14,18,2,2,7,6,44
2008,Glen Davis,C,22,BOS,17,0,137,14,34,0.412,0,1,0,14,33,0.424,0.412,11,18,0.611,12,13,25,7,5,4,10,27,39
2008,Carlos Delfino,SG,25,TOR,5,0,121,15,37,0.405,4,15,0.267,11,22,0.5,0.459,9,10,0.9,5,19,24,11,4,0,3,14,43
2008,Boris Diaw,PF,25,PHO,5,2,178,35,64,0.547,0,7,0,35,57,0.614,0.547,3,6,0.5,7,21,28,23,3,4,11,22,73
2008,Yakhouba Diawara,SG,25,DEN,3,0,8,2,5,0.4,0,2,0,2,3,0.667,0.4,0,0,0,0,1,1,0,0,0,0,0,4
2008,Juan Dixon,PG,29,DET,2,0,7,0,2,0,0,0,0,0,2,0,0,0,0,0,0,0,0,0,0,0,0,0,0
2008,Keyon Dooling,PG,27,ORL,10,0,148,22,56,0.393,9,23,0.391,13,33,0.394,0.473,13,15,0.867,2,8,10,7,6,1,6,22,66
2008,Tim Duncan,C,31,SAS,17,17,666,135,301,0.449,1,5,0.2,134,296,0.453,0.45,72,115,0.626,61,186,247,56,15,35,41,41,343
2008,Melvin Ely,C,29,NOH,7,0,59,4,15,0.267,0,0,0,4,15,0.267,0.267,7,10,0.7,5,6,11,1,0,0,4,13,15
2008,Maurice Evans,SG,29,ORL,10,10,282,35,69,0.507,15,36,0.417,20,33,0.606,0.616,5,8,0.625,7,18,25,7,8,1,9,12,90
2008,Reggie Evans,PF,27,PHI,6,0,148,13,26,0.5,0,0,0,13,26,0.5,0.5,15,24,0.625,16,31,47,3,5,0,13,20,41
2008,Jordan Farmar,PG,21,LAL,21,0,360,44,115,0.383,17,44,0.386,27,71,0.38,0.457,14,16,0.875,7,26,33,27,7,4,17,27,119
2008,Michael Finley,SG,34,SAS,17,11,391,43,107,0.402,19,52,0.365,24,55,0.436,0.491,9,9,1,1,32,33,17,5,3,6,25,114
2008,Derek Fisher,PG,33,LAL,21,21,663,66,146,0.452,22,50,0.44,44,96,0.458,0.527,61,73,0.836,2,45,47,52,43,3,20,62,215
2008,T.J. Ford,PG,24,TOR,5,5,124,21,58,0.362,1,8,0.125,20,50,0.4,0.371,15,16,0.938,3,19,22,33,5,0,10,10,58
2008,Adonal Foyle,C,32,ORL,3,0,11,1,3,0.333,0,0,0,1,3,0.333,0.333,0,0,0,0,3,3,0,0,0,2,1,2
2008,Kevin Garnett,PF,31,BOS,26,26,987,217,438,0.495,2,8,0.25,215,430,0.5,0.498,94,116,0.81,72,202,274,87,35,29,55,74,530
2008,Pat Garrity,PF,31,ORL,2,0,6,0,2,0,0,1,0,0,1,0,0,1,2,0.5,0,2,2,0,0,0,0,0,1
2008,Pau Gasol,C,27,LAL,21,21,836,141,266,0.53,0,0,0,141,266,0.53,0.53,72,104,0.692,55,140,195,83,11,40,44,60,354
2008,Devean George,SF,30,DAL,5,0,62,11,28,0.393,4,12,0.333,7,16,0.438,0.464,3,5,0.6,4,11,15,0,2,2,3,7,29
2008,Daniel Gibson,PG,21,CLE,11,0,284,35,78,0.449,19,42,0.452,16,36,0.444,0.571,10,14,0.714,4,15,19,27,7,2,15,18,99
2008,Manu Ginobili,SG,30,SAS,17,6,559,98,232,0.422,38,102,0.373,60,130,0.462,0.504,69,77,0.896,14,50,64,67,10,5,47,47,303
2008,Gordan Giricek,SG,30,PHO,5,0,80,6,18,0.333,1,4,0.25,5,14,0.357,0.361,4,4,1,0,7,7,2,2,0,3,3,17
2008,Marcin Gortat,C,23,ORL,8,0,48,5,6,0.833,0,0,0,5,6,0.833,0.833,0,0,0,2,6,8,0,0,4,3,5,10
2008,Joey Graham,SF,25,TOR,2,0,2,0,2,0,0,1,0,0,1,0,0,0,0,0,0,0,0,0,0,0,0,0,0
2008,Willie Green,SG,26,PHI,6,6,142,22,51,0.431,1,5,0.2,21,46,0.457,0.441,9,14,0.643,2,6,8,12,5,4,9,19,54
2008,Richard Hamilton,SG,29,DET,17,17,656,134,285,0.47,8,26,0.308,126,259,0.486,0.484,92,101,0.911,19,53,72,67,23,9,48,48,368
2008,Matt Harpring,SF,31,UTA,12,0,209,25,63,0.397,1,3,0.333,24,60,0.4,0.405,28,35,0.8,17,17,34,8,7,4,11,35,79
2008,Mike Harris,PF,24,HOU,3,0,9,1,2,0.5,0,0,0,1,2,0.5,0.5,1,2,0.5,1,1,2,0,0,0,0,0,3
2008,Jason Hart,PG,29,UTA,2,0,6,1,2,0.5,0,1,0,1,1,1,0.5,0,0,0,0,0,0,0,0,0,0,0,2
2008,Chuck Hayes,PF,24,HOU,6,0,108,7,11,0.636,0,2,0,7,9,0.778,0.636,0,0,0,7,21,28,5,3,6,4,18,14
2008,Jarvis Hayes,SF,26,DET,11,0,61,9,30,0.3,5,14,0.357,4,16,0.25,0.383,0,0,0,4,12,16,4,1,2,4,11,23
2008,Brendan Haywood,C,28,WAS,6,6,178,26,44,0.591,0,0,0,26,44,0.591,0.591,20,25,0.8,13,27,40,5,4,9,6,25,72
2008,Luther Head,SG,25,HOU,5,0,44,1,14,0.071,0,6,0,1,8,0.125,0.071,2,2,1,1,1,2,4,2,1,4,3,4
2008,Walter Herrmann,PF,28,DET,4,0,27,1,4,0.25,1,1,1,0,3,0,0.375,2,4,0.5,1,0,1,0,0,0,0,4,5
2008,Nene Hilario,PF,25,DEN,3,0,30,5,9,0.556,0,0,0,5,9,0.556,0.556,3,3,1,3,4,7,1,2,1,2,8,13
2008,Grant Hill*,SF,35,PHO,3,2,68,5,11,0.455,0,0,0,5,11,0.455,0.455,1,1,1,3,13,16,3,2,1,0,3,11
2008,Al Horford,C,21,ATL,7,7,277,34,72,0.472,0,0,0,34,72,0.472,0.472,20,27,0.741,22,51,73,25,3,7,15,26,88
2008,Robert Horry,PF,37,SAS,15,0,154,7,36,0.194,5,22,0.227,2,14,0.143,0.264,4,6,0.667,11,21,32,8,5,5,2,34,23
2008,Eddie House,PG,29,BOS,21,0,165,17,56,0.304,11,31,0.355,6,25,0.24,0.402,7,8,0.875,2,20,22,18,5,1,4,13,52
2008,Dwight Howard,C,22,ORL,10,10,421,72,124,0.581,0,0,0,72,124,0.581,0.581,45,83,0.542,60,98,158,9,8,34,32,38,189
2008,Josh Howard,SF,27,DAL,5,5,171,21,72,0.292,1,10,0.1,20,62,0.323,0.299,20,25,0.8,12,23,35,7,2,2,9,10,63
2008,Juwan Howard,PF,34,DAL,3,0,11,0,2,0,0,0,0,0,2,0,0,1,4,0.25,0,0,0,1,0,0,0,2,1
2008,Kris Humphries,PF,22,TOR,3,0,2,0,0,,0,0,0,0,0,0,,0,0,0,0,0,0,0,0,0,0,0,0
2008,Lindsey Hunter,PG,37,DET,11,0,115,8,21,0.381,5,11,0.455,3,10,0.3,0.5,0,0,0,2,8,10,14,8,0,5,21,21
2008,Steven Hunter,C,26,DEN,2,0,5,0,1,0,0,0,0,0,1,0,0,0,0,0,0,2,2,0,0,0,0,0,0
2008,Andre Iguodala,SF,24,PHI,6,6,234,23,69,0.333,2,14,0.143,21,55,0.382,0.348,31,43,0.721,6,23,29,30,13,1,26,11,79
2008,Zydrunas Ilgauskas,C,32,CLE,13,13,393,67,140,0.479,0,0,0,67,140,0.479,0.479,36,44,0.818,33,65,98,21,5,14,21,35,170
2008,Didier Ilunga-Mbenga,C,27,LAL,7,0,30,5,8,0.625,0,0,0,5,8,0.625,0.625,0,0,0,3,6,9,0,2,1,1,9,10
2008,Allen Iverson*,SG,32,DEN,4,4,158,36,83,0.434,3,14,0.214,33,69,0.478,0.452,23,33,0.697,4,8,12,18,4,1,7,3,98
2008,Bobby Jackson,PG,34,HOU,6,2,138,20,70,0.286,5,24,0.208,15,46,0.326,0.321,7,11,0.636,2,8,10,9,5,0,4,11,52
2008,LeBron James,SF,23,CLE,13,13,552,113,275,0.411,18,70,0.257,95,205,0.463,0.444,122,167,0.731,16,86,102,99,23,17,54,33,366
2008,Mike James,PG,32,NOH,4,0,28,4,12,0.333,2,5,0.4,2,7,0.286,0.417,2,2,1,0,1,1,1,2,0,1,0,12
2008,Antawn Jamison,PF,31,WAS,6,6,237,39,96,0.406,7,25,0.28,32,71,0.451,0.443,16,28,0.571,19,53,72,6,8,8,10,17,101
2008,Amir Johnson,PF,20,DET,8,0,43,9,12,0.75,0,1,0,9,11,0.818,0.75,3,6,0.5,3,10,13,1,0,3,2,7,21
2008,Joe Johnson,SG,26,ATL,7,7,275,47,115,0.409,16,36,0.444,31,79,0.392,0.478,30,33,0.909,9,18,27,28,2,0,16,16,140
2008,Damon Jones,SG,31,CLE,5,0,26,2,10,0.2,2,7,0.286,0,3,0,0.3,0,0,0,0,0,0,1,0,0,1,1,6
2008,Dwayne Jones,PF,24,CLE,5,0,20,1,2,0.5,0,0,0,1,2,0.5,0.5,1,2,0.5,2,4,6,0,0,1,1,4,3
2008,Eddie Jones,SG,36,DAL,3,0,22,2,6,0.333,1,4,0.25,1,2,0.5,0.417,1,1,1,0,3,3,1,1,0,1,3,6
2008,Solomon Jones,PF,23,ATL,7,0,29,2,10,0.2,0,0,0,2,10,0.2,0.2,0,2,0,4,4,8,1,1,3,0,3,4
2008,Jason Kapono,SF,26,TOR,5,0,152,31,53,0.585,13,24,0.542,18,29,0.621,0.708,3,4,0.75,2,11,13,4,2,0,2,9,78
2008,Coby Karl,SG,24,LAL,1,0,2,0,0,,0,0,0,0,0,0,,0,0,0,0,0,0,1,0,0,0,1,0
2008,Jason Kidd*,PG,34,DAL,5,5,180,16,38,0.421,6,13,0.462,10,25,0.4,0.5,5,8,0.625,8,24,32,34,7,2,9,12,43
2008,Andrei Kirilenko,SF,26,UTA,12,12,387,51,114,0.447,5,22,0.227,46,92,0.5,0.469,25,35,0.714,15,26,41,30,18,20,18,46,132
2008,Linas Kleiza,SF,23,DEN,4,3,122,22,41,0.537,3,14,0.214,19,27,0.704,0.573,9,13,0.692,8,18,26,3,1,0,5,11,56
2008,Kyle Korver,SG,26,UTA,12,0,259,30,73,0.411,11,38,0.289,19,35,0.543,0.486,23,25,0.92,5,21,26,7,4,8,8,28,94
2008,Carl Landry,PF,24,HOU,6,0,106,11,26,0.423,0,0,0,11,26,0.423,0.423,12,16,0.75,15,13,28,0,7,3,2,8,34
2008,Acie Law,PG,23,ATL,7,0,61,6,8,0.75,0,0,0,6,8,0.75,0.75,9,10,0.9,0,2,2,8,2,0,8,5,21
2008,Rashard Lewis,PF,28,ORL,10,10,417,71,163,0.436,21,68,0.309,50,95,0.526,0.5,32,39,0.821,24,48,72,34,11,5,23,18,195
2008,Tyronn Lue,PG,30,DAL,2,0,2,0,1,0,0,0,0,0,1,0,0,0,0,0,1,0,1,1,0,0,0,0,0
2008,Sean Marks,C,32,PHO,1,0,3,0,0,,0,0,0,0,0,0,,0,0,0,0,0,0,0,0,0,0,0,0
2008,Kenyon Martin,PF,30,DEN,4,4,118,15,34,0.441,0,0,0,15,34,0.441,0.441,5,8,0.625,13,12,25,5,4,2,9,20,35
2008,Roger Mason,PG,27,WAS,6,0,129,19,47,0.404,4,17,0.235,15,30,0.5,0.447,6,8,0.75,0,5,5,6,3,1,2,11,48
2008,Jason Maxiell,C,24,DET,17,6,371,40,64,0.625,0,0,0,40,64,0.625,0.625,15,32,0.469,21,47,68,16,15,22,11,48,95
2008,Antonio McDyess,PF,33,DET,17,11,468,64,119,0.538,0,0,0,64,119,0.538,0.538,23,28,0.821,48,78,126,16,10,8,20,65,151
2008,Tracy McGrady*,SG,28,HOU,6,6,247,62,146,0.425,5,24,0.208,57,122,0.467,0.442,33,53,0.623,7,42,49,41,9,5,18,8,162
2008,Dominic McGuire,SG,22,WAS,3,0,15,0,0,,0,0,0,0,0,0,,1,2,0.5,1,2,3,1,1,1,0,1,1
2008,Chris Mihm,C,28,LAL,1,0,3,0,1,0,0,0,0,0,1,0,0,0,0,0,0,0,0,0,0,0,1,2,0
2008,C.J. Miles,SG,20,UTA,7,0,26,5,14,0.357,2,8,0.25,3,6,0.5,0.429,0,0,0,1,4,5,0,2,0,2,4,12
2008,Andre Miller,PG,31,PHI,6,6,229,39,89,0.438,0,3,0,39,86,0.453,0.438,14,22,0.636,7,12,19,20,5,0,14,12,92
2008,Paul Millsap,PF,22,UTA,12,0,210,32,62,0.516,0,1,0,32,61,0.525,0.516,13,25,0.52,23,24,47,4,7,16,9,37,77
2008,Jamario Moon,SF,27,TOR,5,3,104,11,29,0.379,4,11,0.364,7,18,0.389,0.448,1,1,1,7,17,24,4,6,3,2,6,27
2008,Dikembe Mutombo*,C,41,HOU,6,6,123,8,13,0.615,0,0,0,8,13,0.615,0.615,7,11,0.636,10,29,39,2,1,11,1,10,23
2008,Eduardo Najera,PF,31,DEN,4,0,78,7,14,0.5,2,5,0.4,5,9,0.556,0.571,0,0,0,5,8,13,6,3,1,5,15,16
2008,Steve Nash*,PG,33,PHO,5,5,183,32,70,0.457,6,20,0.3,26,50,0.52,0.5,11,12,0.917,1,13,14,39,2,1,12,10,81
2008,Jameer Nelson,PG,25,ORL,10,10,333,57,113,0.504,20,41,0.488,37,72,0.514,0.593,28,37,0.757,4,37,41,47,3,2,21,43,162
2008,Rasho Nesterovic,C,31,TOR,5,2,77,11,22,0.5,0,0,0,11,22,0.5,0.5,1,2,0.5,3,10,13,3,1,2,5,14,23
2008,Ira Newble,SF,33,LAL,1,0,1,0,0,,0,0,0,0,0,0,,0,0,0,0,0,0,0,0,0,0,0,0
2008,Steve Novak,SF,24,HOU,3,0,21,3,4,0.75,2,3,0.667,1,1,1,1,0,0,0,1,1,2,0,0,1,0,2,8
2008,Dirk Nowitzki,PF,29,DAL,5,5,211,43,91,0.473,6,18,0.333,37,73,0.507,0.505,42,52,0.808,10,50,60,20,1,7,10,13,134
2008,Shaquille O'Neal*,C,35,PHO,5,5,150,22,50,0.44,0,0,0,22,50,0.44,0.44,32,64,0.5,13,33,46,5,5,13,9,21,76
2008,Fabricio Oberto,PF,32,SAS,17,9,331,28,46,0.609,0,0,0,28,46,0.609,0.609,7,10,0.7,15,56,71,20,6,5,14,48,63
2008,Lamar Odom,PF,28,LAL,21,21,786,107,218,0.491,3,11,0.273,104,207,0.502,0.498,84,127,0.661,47,162,209,62,14,27,47,72,301
2008,Mehmet Okur,C,28,UTA,12,12,462,66,156,0.423,19,51,0.373,47,105,0.448,0.484,34,44,0.773,34,107,141,23,8,8,19,37,185
2008,Kevin Ollie,SG,35,PHI,3,0,19,1,4,0.25,0,0,0,1,4,0.25,0.25,2,2,1,0,1,1,3,2,0,0,1,4
2008,Zaza Pachulia,C,23,ATL,7,0,105,7,25,0.28,0,1,0,7,24,0.292,0.28,15,21,0.714,9,11,20,2,2,0,9,22,29
2008,Jannero Pargo,SG,28,NOH,12,0,265,45,116,0.388,15,43,0.349,30,73,0.411,0.453,17,24,0.708,5,25,30,27,12,2,11,22,122
2008,Anthony Parker,SG,32,TOR,5,5,196,20,49,0.408,5,17,0.294,15,32,0.469,0.459,12,14,0.857,4,26,30,10,4,2,4,12,57
2008,Tony Parker,PG,25,SAS,17,17,654,152,306,0.497,7,20,0.35,145,286,0.507,0.508,70,93,0.753,10,53,63,103,16,1,50,37,381
2008,Chris Paul,PG,22,NOH,12,12,486,111,221,0.502,5,21,0.238,106,200,0.53,0.514,62,79,0.785,16,43,59,135,28,2,22,43,289
2008,Sasha Pavlovic,SG,24,CLE,8,0,111,10,26,0.385,4,9,0.444,6,17,0.353,0.462,4,6,0.667,6,4,10,1,2,0,2,17,28
2008,Oleksiy Pecherov,C,22,WAS,3,0,8,0,1,0,0,0,0,0,1,0,0,2,2,1,0,1,1,0,1,1,0,0,2
2008,Kendrick Perkins,C,23,BOS,25,25,631,62,106,0.585,0,1,0,62,105,0.59,0.585,40,59,0.678,52,101,153,13,15,32,31,91,164
2008,Morris Peterson,SG,30,NOH,12,12,277,33,68,0.485,16,34,0.471,17,34,0.5,0.603,4,6,0.667,3,28,31,7,6,3,5,29,86
2008,Eric Piatkowski,SF,37,PHO,1,0,2,0,0,,0,0,0,0,0,0,,0,0,0,0,0,0,0,0,0,0,1,0
2008,Paul Pierce,SF,30,BOS,26,26,990,163,370,0.441,43,119,0.361,120,251,0.478,0.499,142,177,0.802,21,108,129,119,28,8,82,90,511
2008,James Posey,PF,31,BOS,26,0,573,52,119,0.437,35,88,0.398,17,31,0.548,0.584,35,40,0.875,12,81,93,28,26,8,14,61,174
2008,Leon Powe,C,24,BOS,23,1,270,36,73,0.493,0,0,0,36,73,0.493,0.493,44,66,0.667,32,30,62,4,0,3,12,45,116
2008,Ronnie Price,PG,24,UTA,12,0,68,10,31,0.323,3,14,0.214,7,17,0.412,0.371,10,13,0.769,1,3,4,11,6,2,6,6,33
2008,Tayshaun Prince,SF,27,DET,17,17,671,100,208,0.481,8,25,0.32,92,183,0.503,0.5,27,34,0.794,32,62,94,55,14,8,32,30,235
2008,Vladimir Radmanovic,SF,27,LAL,21,21,481,67,151,0.444,29,78,0.372,38,73,0.521,0.54,5,6,0.833,23,57,80,31,13,1,21,56,168
2008,Shavlik Randolph,PF,24,PHI,2,0,4,0,1,0,0,0,0,0,1,0,0,3,4,0.75,0,0,0,0,0,0,0,1,3
2008,Theo Ratliff,C,34,DET,12,0,131,6,12,0.5,0,0,0,6,12,0.5,0.5,4,8,0.5,14,13,27,1,1,11,4,23,16
2008,J.J. Redick,SG,23,ORL,2,0,10,0,4,0,0,3,0,0,1,0,0,0,0,0,0,1,1,0,0,0,0,1,0
2008,Jeremy Richardson,SF,23,ATL,3,0,6,1,4,0.25,0,0,0,1,4,0.25,0.25,0,0,0,0,0,0,0,0,0,0,1,2
2008,Rajon Rondo,PG,21,BOS,26,26,831,107,263,0.407,5,20,0.25,102,243,0.42,0.416,47,68,0.691,39,68,107,172,45,8,47,74,266
2008,Luis Scola,PF,27,HOU,6,6,220,30,67,0.448,0,1,0,30,66,0.455,0.448,24,35,0.686,24,32,56,8,4,1,12,30,84
2008,Brian Skinner,C,31,PHO,4,0,21,2,4,0.5,0,0,0,2,4,0.5,0.5,4,8,0.5,0,3,3,0,0,3,0,4,8
2008,J.R. Smith,SG,22,DEN,4,0,108,23,43,0.535,7,22,0.318,16,21,0.762,0.616,20,24,0.833,1,6,7,7,4,0,5,12,73
2008,Jason Smith,PF,21,PHI,6,0,82,8,18,0.444,0,1,0,8,17,0.471,0.444,4,4,1,4,11,15,3,1,5,2,5,20
2008,Joe Smith,PF,32,CLE,13,0,263,36,74,0.486,0,1,0,36,73,0.493,0.486,14,22,0.636,20,40,60,6,5,7,6,41,86
2008,Josh Smith,PF,22,ATL,7,7,237,35,88,0.398,3,18,0.167,32,70,0.457,0.415,37,44,0.841,7,38,45,20,12,20,26,26,110
2008,Darius Songaila,C,29,WAS,5,0,77,8,19,0.421,0,0,0,8,19,0.421,0.421,13,15,0.867,4,9,13,4,1,0,6,18,29
2008,Jerry Stackhouse,SG,33,DAL,5,2,102,12,38,0.316,2,12,0.167,10,26,0.385,0.342,5,5,1,4,12,16,6,1,0,7,9,31
2008,DeShawn Stevenson,SG,26,WAS,6,6,196,22,60,0.367,14,36,0.389,8,24,0.333,0.483,16,18,0.889,2,11,13,18,6,0,9,11,74
2008,Peja Stojakovic,SF,30,NOH,12,12,455,58,133,0.436,28,51,0.549,30,82,0.366,0.541,25,27,0.926,6,59,65,6,6,1,8,19,169
2008,Damon Stoudamire,PG,34,SAS,7,0,35,5,15,0.333,1,4,0.25,4,11,0.364,0.367,2,3,0.667,2,5,7,2,1,0,1,0,13
2008,Salim Stoudamire,PG,25,ATL,3,0,28,4,9,0.444,2,6,0.333,2,3,0.667,0.556,2,2,1,0,1,1,0,1,0,3,2,12
2008,Amar'e Stoudemire,C,25,PHO,5,5,204,48,99,0.485,1,4,0.25,47,95,0.495,0.49,19,30,0.633,15,30,45,2,7,12,14,19,116
2008,D.J. Strawberry,SG,22,PHO,1,0,5,0,4,0,0,1,0,0,3,0,0,0,0,0,0,1,1,0,0,0,0,1,0
2008,Rodney Stuckey,PG,21,DET,17,2,380,43,116,0.371,2,7,0.286,41,109,0.376,0.379,51,58,0.879,11,21,32,58,18,2,23,35,139
2008,Wally Szczerbiak,SF,30,CLE,13,13,374,47,125,0.376,20,62,0.323,27,63,0.429,0.456,26,28,0.929,4,19,23,19,2,1,10,32,140
2008,Jason Terry,SG,30,DAL,5,3,180,26,60,0.433,14,32,0.438,12,28,0.429,0.55,13,15,0.867,1,7,8,24,2,1,5,15,79
2008,Billy Thomas,SF,32,CLE,3,0,8,1,2,0.5,1,2,0.5,0,0,0,0.75,0,0,0,0,1,1,1,1,0,0,0,3
2008,Kurt Thomas,PF,35,SAS,17,8,268,32,70,0.457,0,0,0,32,70,0.457,0.457,5,7,0.714,26,58,84,6,2,6,13,46,69
2008,Ronny Turiaf,C,25,LAL,19,0,187,14,36,0.389,0,0,0,14,36,0.389,0.389,10,17,0.588,6,21,27,5,2,18,9,41,38
2008,Hedo Turkoglu,SF,28,ORL,10,10,399,63,141,0.447,10,35,0.286,53,106,0.5,0.482,39,46,0.848,14,50,64,55,8,2,38,35,175
2008,Ime Udoka,PF,30,SAS,16,0,236,33,71,0.465,16,40,0.4,17,31,0.548,0.577,5,7,0.714,7,40,47,17,11,2,11,25,87
2008,Anderson Varejao,C,25,CLE,13,0,240,22,54,0.407,0,0,0,22,54,0.407,0.407,9,21,0.429,20,47,67,9,8,1,9,30,53
2008,Jacque Vaughn,PG,32,SAS,14,0,91,6,22,0.273,0,1,0,6,21,0.286,0.273,0,0,0,2,7,9,8,2,0,7,17,12
2008,Sasha Vujacic,SG,23,LAL,21,0,456,55,138,0.399,31,79,0.392,24,59,0.407,0.511,30,35,0.857,8,38,46,16,12,4,18,44,171
2008,Ben Wallace,PF,33,CLE,13,13,304,17,33,0.515,0,0,0,17,33,0.515,0.515,7,20,0.35,32,52,84,15,8,14,7,26,41
2008,Rasheed Wallace,C,33,DET,17,17,585,86,203,0.424,24,75,0.32,62,128,0.484,0.483,29,39,0.744,19,89,108,28,19,33,29,67,225
2008,Luke Walton,SF,27,LAL,21,0,353,44,97,0.454,11,26,0.423,33,71,0.465,0.51,26,36,0.722,13,42,55,41,11,4,20,49,125
2008,Bonzi Wells,SG,31,NOH,12,0,170,22,57,0.386,0,2,0,22,55,0.4,0.386,0,6,0,4,27,31,8,4,3,6,26,44
2008,David West,PF,27,NOH,12,12,485,102,219,0.466,1,2,0.5,101,217,0.465,0.468,49,55,0.891,21,81,102,34,13,23,21,32,254
2008,Delonte West,PG,24,CLE,13,13,453,44,110,0.4,18,42,0.429,26,68,0.382,0.482,35,41,0.854,8,35,43,54,15,6,32,40,141
2008,Mario West,SG,23,ATL,6,0,6,1,3,0.333,0,0,0,1,3,0.333,0.333,0,1,0,1,1,2,0,0,0,0,0,2
2008,Deron Williams,PG,23,UTA,12,12,513,90,183,0.492,28,56,0.5,62,127,0.488,0.568,51,66,0.773,16,27,43,120,7,4,37,35,259
2008,Lou Williams,PG,21,PHI,6,0,135,24,60,0.4,2,9,0.222,22,51,0.431,0.417,22,30,0.733,3,9,12,12,6,0,7,11,72
2008,Marvin Williams,SF,21,ATL,7,7,199,24,58,0.414,0,0,0,24,58,0.414,0.414,32,36,0.889,11,17,28,5,2,3,13,21,80
2008,Loren Woods,C,29,HOU,1,0,1,1,1,1,0,0,0,1,1,1,1,0,0,0,1,0,1,0,0,0,0,0,2
2008,Antoine Wright,SG,23,DAL,1,0,7,0,0,,0,0,0,0,0,0,,0,0,0,0,1,1,0,0,0,2,0,0
2008,Julian Wright,SF,20,NOH,11,0,131,20,44,0.455,2,9,0.222,18,35,0.514,0.477,5,6,0.833,6,12,18,5,10,1,5,8,47
2008,Nick Young,SG,22,WAS,4,0,17,1,9,0.111,0,2,0,1,7,0.143,0.111,3,4,0.75,1,1,2,1,2,0,1,1,5
2008,Thaddeus Young,PF,19,PHI,6,6,160,24,50,0.48,1,5,0.2,23,45,0.511,0.49,12,14,0.857,15,12,27,4,7,0,4,7,61
2009,Arron Afflalo,SG,23,DET,4,0,66,10,21,0.476,2,10,0.2,8,11,0.727,0.524,3,5,0.6,1,2,3,1,0,2,3,9,25
2009,LaMarcus Aldridge,PF,23,POR,6,6,237,51,104,0.49,1,4,0.25,50,100,0.5,0.495,14,20,0.7,9,36,45,8,3,10,10,16,117
2009,Ray Allen*,SG,33,BOS,14,14,565,83,206,0.403,35,100,0.35,48,106,0.453,0.488,55,58,0.948,13,42,55,37,15,5,25,35,256
2009,Tony Allen,SG,27,BOS,10,0,60,4,8,0.5,0,0,0,4,8,0.5,0.5,1,1,1,1,8,9,3,2,0,1,4,9
2009,Rafer Alston,PG,32,ORL,23,23,740,106,279,0.38,36,113,0.319,70,166,0.422,0.444,33,44,0.75,3,53,56,94,33,4,40,53,281
2009,Chris Andersen,C,30,DEN,15,0,328,34,54,0.63,0,1,0,34,53,0.642,0.63,29,44,0.659,29,66,95,9,5,32,8,42,97
2009,Carmelo Anthony,SF,24,DEN,16,16,612,146,322,0.453,24,66,0.364,122,256,0.477,0.491,119,144,0.826,26,67,93,65,28,10,37,60,435
2009,Joel Anthony,C,26,MIA,6,2,88,4,5,0.8,0,0,0,4,5,0.8,0.8,2,2,1,9,10,19,2,0,7,1,9,10
2009,Trevor Ariza,SF,23,LAL,23,23,722,92,185,0.497,40,84,0.476,52,101,0.515,0.605,36,64,0.563,22,75,97,54,36,10,38,73,260
2009,Hilton Armstrong,C,24,NOH,4,1,53,6,13,0.462,0,0,0,6,13,0.462,0.462,3,10,0.3,3,5,8,1,4,1,6,15,15
2009,Renaldo Balkman,PF,24,DEN,8,0,20,2,6,0.333,0,1,0,2,5,0.4,0.333,0,0,0,2,2,4,1,4,0,0,3,4
2009,J.J. Barea,SG,24,DAL,10,4,221,31,71,0.437,5,16,0.313,26,55,0.473,0.472,9,13,0.692,3,17,20,34,3,0,6,13,76
2009,Brent Barry,SG,37,HOU,4,0,35,5,10,0.5,3,8,0.375,2,2,1,0.65,0,0,0,0,4,4,3,2,0,4,3,13
2009,Brandon Bass,C,23,DAL,10,0,192,33,60,0.55,0,0,0,33,60,0.55,0.55,28,31,0.903,13,28,41,7,7,4,4,22,94
2009,Tony Battie,PF,32,ORL,21,0,128,21,45,0.467,0,0,0,21,45,0.467,0.467,3,5,0.6,7,13,20,2,0,3,2,12,45
2009,Shane Battier,SG,30,HOU,13,13,496,33,81,0.407,17,54,0.315,16,27,0.593,0.512,22,23,0.957,21,43,64,31,14,9,15,33,105
2009,Nicolas Batum,SF,20,POR,6,5,63,5,9,0.556,2,4,0.5,3,5,0.6,0.667,0,0,0,1,2,3,1,1,2,3,7,12
2009,Jerryd Bayless,PG,20,POR,2,0,11,2,6,0.333,0,1,0,2,5,0.4,0.333,2,3,0.667,0,1,1,0,0,1,1,0,6
2009,Michael Beasley,PF,20,MIA,7,0,178,34,88,0.386,4,13,0.308,30,75,0.4,0.409,13,17,0.765,10,41,51,7,2,7,11,14,85
2009,Mike Bibby,PG,30,ATL,11,11,390,49,106,0.462,26,48,0.542,23,58,0.397,0.585,21,22,0.955,6,31,37,46,10,2,24,34,145
2009,Chauncey Billups,PG,32,DEN,16,16,619,90,197,0.457,44,94,0.468,46,103,0.447,0.569,106,117,0.906,5,56,61,109,20,4,31,38,330
2009,Steve Blake,PG,28,POR,6,6,231,22,45,0.489,10,24,0.417,12,21,0.571,0.6,5,7,0.714,4,20,24,37,5,0,9,11,59
2009,Matt Bonner,PF,28,SAS,5,5,100,5,23,0.217,3,13,0.231,2,10,0.2,0.283,2,2,1,6,10,16,0,3,2,2,10,15
2009,Carlos Boozer,PF,27,UTA,5,5,186,38,72,0.528,0,0,0,38,72,0.528,0.528,27,35,0.771,12,54,66,11,8,2,15,18,103
2009,Bruce Bowen,SF,37,SAS,5,2,130,7,13,0.538,5,9,0.556,2,4,0.5,0.731,2,2,1,0,15,15,3,3,0,3,10,21
2009,Ryan Bowen,SF,33,NOH,1,0,2,0,1,0,0,0,0,0,1,0,0,0,0,0,0,0,0,0,0,0,0,1,0
2009,Ronnie Brewer,SF,23,UTA,5,5,158,20,49,0.408,0,2,0,20,47,0.426,0.408,11,16,0.688,7,16,23,13,7,1,11,9,51
2009,Aaron Brooks,PG,24,HOU,13,13,444,77,170,0.453,27,64,0.422,50,106,0.472,0.532,37,46,0.804,4,30,34,44,5,3,29,29,218
2009,Devin Brown,SG,30,NOH,3,0,33,3,8,0.375,0,4,0,3,4,0.75,0.375,2,2,1,2,3,5,0,0,0,3,2,8
2009,Kwame Brown,C,26,DET,3,0,48,3,8,0.375,0,0,0,3,8,0.375,0.375,3,4,0.75,6,9,15,0,0,3,3,12,9
2009,Shannon Brown,SG,23,LAL,21,0,276,36,83,0.434,12,25,0.48,24,58,0.414,0.506,19,24,0.792,8,17,25,13,10,2,10,27,103
2009,Kobe Bryant,SG,30,LAL,23,23,940,242,530,0.457,37,106,0.349,205,424,0.483,0.492,174,197,0.883,19,104,123,126,38,21,59,59,695
2009,Rasual Butler,SF,29,NOH,5,5,158,17,37,0.459,10,19,0.526,7,18,0.389,0.595,9,9,1,3,12,15,1,1,4,6,14,53
2009,Andrew Bynum,C,21,LAL,23,18,400,58,127,0.457,0,0,0,58,127,0.457,0.457,28,43,0.651,33,53,86,10,8,21,19,77,144
2009,Will Bynum,PG,26,DET,4,0,78,18,39,0.462,1,4,0.25,17,35,0.486,0.474,10,10,1,1,5,6,10,5,0,8,9,47
2009,Matt Carroll,SG,28,DAL,4,0,14,1,2,0.5,0,0,0,1,2,0.5,0.5,0,0,0,0,2,2,0,0,0,1,1,2
2009,Anthony Carter,PG,33,DEN,16,0,228,20,49,0.408,2,12,0.167,18,37,0.486,0.429,2,4,0.5,11,21,32,34,15,1,11,27,44
2009,Mario Chalmers,PG,22,MIA,7,7,231,20,50,0.4,6,21,0.286,14,29,0.483,0.46,5,7,0.714,6,13,19,31,20,1,17,21,51
2009,Tyson Chandler,C,26,NOH,4,4,94,6,12,0.5,0,0,0,6,12,0.5,0.5,3,6,0.5,8,13,21,2,2,1,8,17,15
2009,Speedy Claxton,PG,30,ATL,1,0,3,0,0,,0,0,0,0,0,0,,0,0,0,0,0,0,0,0,0,0,0,0
2009,Jarron Collins,C,30,UTA,3,3,35,1,5,0.2,0,0,0,1,5,0.2,0.2,6,8,0.75,4,6,10,1,1,0,0,9,8
2009,Brian Cook,PF,28,HOU,6,0,32,4,15,0.267,2,9,0.222,2,6,0.333,0.333,0,0,0,3,9,12,3,2,1,4,4,10
2009,Daequan Cook,SF,21,MIA,7,0,161,13,42,0.31,9,30,0.3,4,12,0.333,0.417,2,2,1,3,14,17,4,2,0,6,18,37
2009,Samuel Dalembert,C,27,PHI,6,6,133,16,25,0.64,0,0,0,16,25,0.64,0.64,3,4,0.75,10,37,47,3,2,9,6,24,35
2009,Erick Dampier,C,33,DAL,10,10,255,22,36,0.611,0,0,0,22,36,0.611,0.611,13,21,0.619,25,36,61,7,4,9,19,41,57
2009,Antonio Daniels,PG,33,NOH,5,0,64,2,13,0.154,1,4,0.25,1,9,0.111,0.192,9,11,0.818,1,2,3,9,2,1,5,1,14
2009,Glen Davis,C,23,BOS,14,14,510,86,175,0.491,0,0,0,86,175,0.491,0.491,49,69,0.71,33,46,79,25,18,8,20,59,221
2009,Yakhouba Diawara,SF,26,MIA,5,0,21,1,3,0.333,0,1,0,1,2,0.5,0.333,0,2,0,0,5,5,0,1,0,0,2,2
2009,Tim Duncan,C,32,SAS,5,5,164,41,77,0.532,0,0,0,41,77,0.532,0.532,17,28,0.607,12,28,40,16,3,6,7,11,99
2009,Maurice Evans,SF,30,ATL,11,8,265,28,65,0.431,8,28,0.286,20,37,0.541,0.492,4,6,0.667,8,8,16,10,6,3,4,29,68
2009,Reggie Evans,PF,28,PHI,5,0,36,2,9,0.222,0,0,0,2,9,0.222,0.222,3,4,0.75,2,8,10,0,3,0,2,4,7
2009,Jordan Farmar,PG,22,LAL,20,1,260,34,87,0.391,12,39,0.308,22,48,0.458,0.46,14,19,0.737,5,23,28,33,9,3,18,16,94
2009,Rudy Fernandez,SG,23,POR,6,1,162,15,35,0.429,8,19,0.421,7,16,0.438,0.543,7,7,1,2,15,17,6,8,3,9,12,45
2009,Michael Finley,SF,35,SAS,5,5,143,15,34,0.441,7,15,0.467,8,19,0.421,0.544,3,4,0.75,3,12,15,5,1,1,4,8,40
2009,Derek Fisher,PG,34,LAL,22,22,635,63,160,0.394,19,67,0.284,44,93,0.473,0.453,31,36,0.861,7,38,45,49,21,1,24,61,176
2009,Adonal Foyle,C,33,ORL,2,0,4,0,1,0,0,0,0,0,1,0,0,0,0,0,0,1,1,0,0,0,1,1,0
2009,Channing Frye,PF,25,POR,4,0,36,5,14,0.357,0,0,0,5,14,0.357,0.357,2,3,0.667,1,2,3,1,0,0,0,5,12
2009,Thomas Gardner,SG,23,ATL,3,0,19,5,13,0.385,3,6,0.5,2,7,0.286,0.5,1,1,1,0,2,2,2,1,0,0,4,14
2009,Pau Gasol,C,28,LAL,23,23,931,160,276,0.58,0,0,0,160,276,0.58,0.58,100,140,0.714,68,181,249,58,19,45,44,69,420
2009,Daniel Gibson,PG,22,CLE,14,0,172,13,40,0.325,10,28,0.357,3,12,0.25,0.45,11,11,1,1,6,7,6,1,3,7,18,47
2009,Drew Gooden,PF,27,SAS,4,0,71,11,33,0.333,0,2,0,11,31,0.355,0.333,7,7,1,5,10,15,1,1,1,3,13,29
2009,Ben Gordon,SG,25,CHI,7,7,304,52,134,0.388,17,46,0.37,35,88,0.398,0.451,49,56,0.875,3,17,20,21,3,1,8,22,170
2009,Marcin Gortat,PF,24,ORL,24,1,271,34,52,0.654,0,0,0,34,52,0.654,0.654,10,16,0.625,18,58,76,3,9,15,11,39,78
2009,Aaron Gray,C,24,CHI,2,0,9,0,2,0,0,0,0,0,2,0,0,0,0,0,0,1,1,0,0,0,1,0,0
2009,Gerald Green,SG,23,DAL,6,0,26,4,14,0.286,1,5,0.2,3,9,0.333,0.321,2,4,0.5,0,2,2,0,1,0,2,4,11
2009,Willie Green,SG,27,PHI,6,6,148,21,51,0.412,4,11,0.364,17,40,0.425,0.451,1,3,0.333,0,6,6,7,0,1,5,13,47
2009,Richard Hamilton,SG,30,DET,4,4,154,21,59,0.356,2,10,0.2,19,49,0.388,0.373,9,10,0.9,2,9,11,20,5,1,10,12,53
2009,Matt Harpring,SG,32,UTA,5,0,49,11,22,0.5,0,1,0,11,21,0.524,0.5,2,2,1,3,6,9,4,2,1,2,12,24
2009,Jason Hart,PG,30,DEN,9,0,19,1,2,0.5,0,0,0,1,2,0.5,0.5,0,0,0,0,3,3,5,2,1,1,5,2
2009,Udonis Haslem,PF,28,MIA,7,7,204,25,46,0.543,0,0,0,25,46,0.543,0.543,9,10,0.9,13,48,61,3,3,3,6,19,59
2009,Chuck Hayes,C,25,HOU,13,4,173,10,21,0.476,0,2,0,10,19,0.526,0.476,0,0,0,13,26,39,10,13,2,4,27,20
2009,Walter Herrmann,SF,29,DET,4,0,22,3,8,0.375,2,4,0.5,1,4,0.25,0.5,0,0,0,1,0,1,2,1,0,0,3,8
2009,Nene Hilario,C,26,DEN,16,16,525,69,126,0.548,0,0,0,69,126,0.548,0.548,46,70,0.657,37,83,120,42,20,10,31,65,184
2009,George Hill,PG,22,SAS,4,0,76,7,21,0.333,3,8,0.375,4,13,0.308,0.405,6,7,0.857,3,5,8,2,2,1,2,6,23
2009,Kirk Hinrich,SG,28,CHI,7,0,210,29,62,0.468,13,30,0.433,16,32,0.5,0.573,17,25,0.68,2,17,19,20,12,3,8,18,88
2009,Ryan Hollins,C,24,DAL,9,0,84,8,14,0.571,0,0,0,8,14,0.571,0.571,6,10,0.6,9,15,24,1,1,4,4,22,22
2009,Al Horford,C,22,ATL,9,9,252,25,59,0.424,0,1,0,25,58,0.431,0.424,12,18,0.667,12,40,52,18,6,6,4,26,62
2009,Eddie House,PG,30,BOS,14,0,232,40,77,0.519,18,37,0.486,22,40,0.55,0.636,10,11,0.909,2,18,20,13,11,0,6,26,108
2009,Dwight Howard,C,23,ORL,23,23,903,161,268,0.601,0,2,0,161,266,0.605,0.601,145,228,0.636,99,254,353,43,20,60,67,102,467
2009,Josh Howard,SF,28,DAL,10,10,295,56,128,0.438,8,32,0.25,48,96,0.5,0.469,38,49,0.776,10,41,51,13,9,4,21,24,158
2009,Lindsey Hunter,PG,38,CHI,6,0,24,1,3,0.333,1,3,0.333,0,0,0,0.5,3,4,0.75,0,5,5,5,2,0,0,3,6
2009,Othello Hunter,PF,22,ATL,4,0,14,2,3,0.667,0,0,0,2,3,0.667,0.667,0,0,0,3,3,6,0,1,1,0,1,4
2009,Andre Iguodala,SF,25,PHI,6,6,269,44,98,0.449,11,28,0.393,33,70,0.471,0.505,30,46,0.652,6,32,38,40,11,0,24,9,129
2009,Zydrunas Ilgauskas,C,33,CLE,14,14,407,62,138,0.449,2,13,0.154,60,125,0.48,0.457,21,33,0.636,27,82,109,17,5,13,9,47,147
2009,Didier Ilunga-Mbenga,C,28,LAL,7,0,16,1,6,0.167,0,0,0,1,6,0.167,0.167,0,0,0,0,3,3,0,0,2,2,0,2
2009,Royal Ivey,SG,27,PHI,6,0,45,3,11,0.273,2,7,0.286,1,4,0.25,0.364,3,4,0.75,1,3,4,0,3,0,0,6,11
2009,Darnell Jackson,PF,23,CLE,5,0,25,1,5,0.2,0,0,0,1,5,0.2,0.2,0,2,0,0,5,5,1,0,0,1,5,2
2009,LeBron James,SF,24,CLE,14,14,580,159,312,0.51,27,81,0.333,132,231,0.571,0.553,149,199,0.749,19,109,128,102,23,12,38,30,494
2009,Amir Johnson,PF,21,DET,3,0,13,1,1,1,0,0,0,1,1,1,1,0,0,0,1,2,3,0,0,1,0,3,2
2009,Anthony Johnson,PG,34,ORL,19,1,280,32,85,0.376,9,30,0.3,23,55,0.418,0.429,9,18,0.5,7,19,26,39,11,0,12,28,82
2009,Joe Johnson,SG,27,ATL,11,11,429,70,168,0.417,12,35,0.343,58,133,0.436,0.452,28,45,0.622,17,32,49,39,14,0,32,24,180
2009,Linton Johnson,PF,28,CHI,3,0,10,1,2,0.5,0,0,0,1,2,0.5,0.5,2,2,1,2,2,4,1,0,0,0,1,4
2009,Dahntay Jones,SG,28,DEN,16,16,280,38,79,0.481,3,12,0.25,35,67,0.522,0.5,33,43,0.767,16,22,38,10,13,5,13,41,112
2009,James Jones,SF,28,MIA,7,7,235,17,32,0.531,11,22,0.5,6,10,0.6,0.703,22,24,0.917,2,14,16,5,3,1,4,19,67
2009,Solomon Jones,C,24,ATL,9,1,77,6,12,0.5,0,0,0,6,12,0.5,0.5,2,2,1,9,7,16,2,1,0,1,9,14
2009,Jason Kidd*,PG,35,DAL,10,10,386,38,83,0.458,21,47,0.447,17,36,0.472,0.584,17,20,0.85,7,51,58,59,22,3,20,24,114
2009,Tarence Kinsey,SG,24,CLE,9,0,11,1,3,0.333,0,0,0,1,3,0.333,0.333,2,2,1,1,1,2,0,1,0,1,2,4
2009,Andrei Kirilenko,PF,27,UTA,5,3,136,22,47,0.468,1,5,0.2,21,42,0.5,0.479,10,14,0.714,7,7,14,10,11,3,5,6,55
2009,Linas Kleiza,SF,24,DEN,14,0,210,31,66,0.47,17,40,0.425,14,26,0.538,0.598,18,24,0.75,8,37,45,7,5,1,2,17,97
2009,Brevin Knight,PG,33,UTA,5,0,17,0,3,0,0,0,0,0,3,0,0,0,0,0,0,1,1,3,1,0,3,4,0
2009,Kyle Korver,SF,27,UTA,5,2,136,18,46,0.391,12,26,0.462,6,20,0.3,0.522,5,7,0.714,2,9,11,13,3,1,2,9,53
2009,Carl Landry,PF,25,HOU,13,0,240,39,70,0.557,0,2,0,39,68,0.574,0.557,19,33,0.576,16,35,51,3,4,5,14,27,97
2009,Acie Law,PG,24,ATL,6,0,28,3,9,0.333,1,3,0.333,2,6,0.333,0.389,1,1,1,1,1,2,6,0,0,1,3,8
2009,Courtney Lee,SG,23,ORL,21,16,550,67,154,0.435,12,44,0.273,55,110,0.5,0.474,23,26,0.885,6,33,39,27,19,3,20,42,169
2009,Rashard Lewis,PF,29,ORL,24,24,986,156,348,0.448,52,132,0.394,104,216,0.481,0.523,91,116,0.784,29,124,153,70,25,13,50,50,455
2009,Kyle Lowry,PG,22,HOU,13,0,254,21,63,0.333,4,16,0.25,17,47,0.362,0.365,23,31,0.742,8,30,38,32,12,1,17,23,69
2009,Tyronn Lue,PG,31,ORL,1,0,4,2,2,1,1,1,1,1,1,1,1.25,0,0,0,0,0,0,0,0,0,0,0,5
2009,Jamaal Magloire,C,30,MIA,6,0,47,1,3,0.333,0,0,0,1,3,0.333,0.333,0,0,0,5,6,11,1,0,0,3,9,2
2009,Stephon Marbury,PG,31,BOS,14,0,166,20,66,0.303,3,12,0.25,17,54,0.315,0.326,9,9,1,2,11,13,25,1,0,10,15,52
2009,Sean Marks,C,33,NOH,5,0,80,6,13,0.462,0,1,0,6,12,0.5,0.462,4,5,0.8,10,10,20,0,3,2,2,9,16
2009,Donyell Marshall,PF,35,PHI,6,0,50,6,16,0.375,4,11,0.364,2,5,0.4,0.5,0,0,0,0,7,7,0,1,1,2,9,16
2009,Kenyon Martin,PF,31,DEN,16,16,538,75,151,0.497,1,5,0.2,74,146,0.507,0.5,23,35,0.657,24,70,94,34,18,14,26,60,174
2009,Roger Mason,SG,28,SAS,5,3,108,12,32,0.375,7,19,0.368,5,13,0.385,0.484,2,3,0.667,0,8,8,9,1,0,4,10,33
2009,Jason Maxiell,C,25,DET,4,0,64,5,10,0.5,0,0,0,5,10,0.5,0.5,5,9,0.556,7,6,13,2,1,1,1,5,15
2009,Antonio McDyess,PF,34,DET,4,4,136,23,44,0.523,0,0,0,23,44,0.523,0.523,6,6,1,6,28,34,2,2,3,5,17,52
2009,C.J. Miles,SG,21,UTA,5,0,58,6,20,0.3,2,8,0.25,4,12,0.333,0.35,3,4,0.75,2,5,7,1,2,1,3,8,17
2009,Andre Miller,PG,32,PHI,6,6,258,48,101,0.475,3,10,0.3,45,91,0.495,0.49,28,34,0.824,9,29,38,32,7,1,19,17,127
2009,Brad Miller,C,32,CHI,7,0,186,24,51,0.471,5,7,0.714,19,44,0.432,0.52,19,24,0.792,11,44,55,9,2,6,21,25,72
2009,Paul Millsap,PF,23,UTA,5,0,155,25,49,0.51,0,0,0,25,49,0.51,0.51,9,18,0.5,20,20,40,8,4,5,6,17,59
2009,Yao Ming*,C,28,HOU,9,9,323,54,99,0.545,0,0,0,54,99,0.545,0.545,46,51,0.902,19,79,98,9,4,11,17,27,154
2009,Jamario Moon,SF,28,MIA,3,0,40,5,5,1,2,2,1,3,3,1,1.2,0,2,0,3,6,9,1,1,1,2,5,12
2009,Mikki Moore,C,33,BOS,10,0,66,5,10,0.5,0,0,0,5,10,0.5,0.5,5,6,0.833,6,9,15,4,2,5,1,11,15
2009,Randolph Morris,C,23,ATL,3,0,8,0,1,0,0,0,0,0,1,0,0,0,0,0,1,1,2,0,1,0,1,2,0
2009,Ronald Murray,SG,29,ATL,11,0,341,42,123,0.341,14,50,0.28,28,73,0.384,0.398,32,37,0.865,6,24,30,28,12,3,14,17,130
2009,Dikembe Mutombo*,C,42,HOU,2,0,20,0,0,,0,0,0,0,0,0,,0,2,0,1,8,9,0,1,2,0,5,0
2009,Jameer Nelson,PG,26,ORL,5,0,90,8,23,0.348,1,6,0.167,7,17,0.412,0.37,2,4,0.5,1,6,7,14,1,0,7,3,19
2009,Joakim Noah,C,23,CHI,7,7,271,26,51,0.51,0,0,0,26,51,0.51,0.51,19,25,0.76,28,64,92,16,6,15,8,31,71
2009,Dirk Nowitzki,PF,30,DAL,10,10,394,88,170,0.518,6,21,0.286,82,149,0.55,0.535,86,93,0.925,12,89,101,31,9,8,23,21,268
2009,Jermaine O'Neal,C,30,MIA,6,5,162,28,51,0.549,0,0,0,28,51,0.549,0.549,24,32,0.75,7,20,27,9,3,9,10,18,80
2009,Fabricio Oberto,C,33,SAS,2,0,22,4,6,0.667,0,0,0,4,6,0.667,0.667,4,4,1,2,2,4,0,2,0,2,2,12
2009,Greg Oden,C,21,POR,6,0,96,11,21,0.524,0,0,0,11,21,0.524,0.524,8,12,0.667,11,15,26,0,2,5,8,27,30
2009,Lamar Odom,PF,29,LAL,23,5,735,108,206,0.524,18,35,0.514,90,171,0.526,0.568,49,80,0.613,64,146,210,42,16,31,39,75,283
2009,Mehmet Okur,C,29,UTA,2,2,43,2,12,0.167,1,3,0.333,1,9,0.111,0.208,3,4,0.75,2,8,10,4,0,1,2,6,8
2009,Travis Outlaw,SF,24,POR,6,0,170,21,66,0.318,4,16,0.25,17,50,0.34,0.348,8,12,0.667,2,16,18,3,5,4,5,10,54
2009,Zaza Pachulia,C,24,ATL,11,1,260,22,53,0.415,0,0,0,22,53,0.415,0.415,32,42,0.762,28,48,76,3,5,3,14,40,76
2009,Tony Parker,PG,26,SAS,5,5,181,59,108,0.546,3,14,0.214,56,94,0.596,0.56,22,31,0.71,1,20,21,34,6,1,21,13,143
2009,Chris Paul,PG,23,NOH,5,5,201,30,73,0.411,5,16,0.313,25,57,0.439,0.445,18,21,0.857,4,18,22,52,8,0,24,8,83
2009,Sasha Pavlovic,SF,25,CLE,11,0,91,10,20,0.5,2,8,0.25,8,12,0.667,0.55,1,3,0.333,1,14,15,4,4,0,3,9,23
2009,Kendrick Perkins,C,24,BOS,14,14,512,73,127,0.575,0,1,0,73,126,0.579,0.575,20,30,0.667,51,111,162,20,6,37,33,51,166
2009,Morris Peterson,SG,31,NOH,2,0,21,1,5,0.2,1,3,0.333,0,2,0,0.3,3,4,0.75,1,2,3,1,1,0,0,3,6
2009,Johan Petro,C,23,DEN,10,0,26,2,9,0.222,0,0,0,2,9,0.222,0.222,5,8,0.625,2,4,6,1,0,1,1,4,9
2009,Paul Pierce,SF,31,BOS,14,14,556,95,221,0.43,19,57,0.333,76,164,0.463,0.473,85,101,0.842,4,77,81,43,15,5,33,44,294
2009,Mickael Pietrus,SG,26,ORL,24,0,618,84,174,0.483,37,96,0.385,47,78,0.603,0.589,47,65,0.723,19,43,62,14,18,13,22,77,252
2009,James Posey,SG,32,NOH,5,0,123,15,40,0.375,5,19,0.263,10,21,0.476,0.438,22,26,0.846,5,26,31,3,3,0,10,12,57
2009,Leon Powe,PF,25,BOS,2,0,24,3,7,0.429,0,0,0,3,7,0.429,0.429,4,6,0.667,1,8,9,0,0,0,1,3,10
2009,Josh Powell,PF,26,LAL,14,0,73,11,26,0.423,1,1,1,10,25,0.4,0.442,6,6,1,7,10,17,4,0,1,4,8,29
2009,Ronnie Price,PG,25,UTA,2,0,16,3,10,0.3,0,3,0,3,7,0.429,0.3,2,2,1,3,0,3,5,1,0,0,4,8
2009,Tayshaun Prince,SF,28,DET,4,4,129,7,27,0.259,1,5,0.2,6,22,0.273,0.278,0,0,0,1,13,14,5,1,0,5,4,15
2009,Gabe Pruitt,SG,22,BOS,4,0,11,0,3,0,0,1,0,0,2,0,0,0,0,0,0,0,0,2,0,1,2,0,0
2009,Joel Przybilla,C,29,POR,6,6,162,10,18,0.556,0,0,0,10,18,0.556,0.556,3,6,0.5,19,25,44,8,4,12,3,21,23
2009,Chris Quinn,PG,25,MIA,5,0,24,3,7,0.429,0,1,0,3,6,0.5,0.429,2,2,1,0,1,1,5,2,0,2,1,8
2009,Theo Ratliff,C,35,PHI,6,0,94,9,11,0.818,0,0,0,9,11,0.818,0.818,2,4,0.5,6,17,23,0,1,4,4,24,20
2009,J.J. Redick,SG,24,ORL,16,8,327,31,83,0.373,21,52,0.404,10,31,0.323,0.5,13,14,0.929,2,17,19,31,8,1,7,26,96
2009,Jeremy Richardson,SF,24,ORL,1,0,2,0,1,0,0,0,0,0,1,0,0,0,0,0,0,0,0,0,0,0,1,0,0
2009,Anthony Roberson,PG,25,CHI,1,0,4,3,4,0.75,2,2,1,1,2,0.5,1,0,0,0,1,0,1,0,2,0,1,0,8
2009,Sergio Rodriguez,PG,22,POR,5,0,27,2,6,0.333,0,0,0,2,6,0.333,0.333,0,0,0,1,2,3,7,0,1,2,5,4
2009,Rajon Rondo,PG,22,BOS,14,14,577,93,223,0.417,6,24,0.25,87,199,0.437,0.43,44,67,0.657,32,104,136,137,35,3,38,47,236
2009,Derrick Rose,PG,20,CHI,7,7,313,59,120,0.492,0,4,0,59,116,0.509,0.492,20,25,0.8,12,32,44,45,4,5,35,25,138
2009,Brandon Roy,SG,24,POR,6,6,238,56,122,0.459,8,17,0.471,48,105,0.457,0.492,40,46,0.87,6,23,29,17,8,7,13,15,160
2009,Michael Ruffin,PF,32,POR,1,0,5,0,1,0,0,0,0,0,1,0,0,1,2,0.5,3,2,5,0,0,0,1,1,1
2009,John Salmons,SF,29,CHI,7,7,313,43,107,0.402,12,38,0.316,31,69,0.449,0.458,29,34,0.853,6,25,31,16,9,7,12,20,127
2009,Brian Scalabrine,C,30,BOS,12,0,246,22,52,0.423,13,29,0.448,9,23,0.391,0.548,4,4,1,7,19,26,12,2,5,5,43,61
2009,Luis Scola,PF,28,HOU,13,13,424,77,156,0.494,0,0,0,77,156,0.494,0.494,33,49,0.673,28,81,109,23,7,3,22,45,187
2009,James Singleton,PF,27,DAL,9,0,42,5,10,0.5,2,5,0.4,3,5,0.6,0.6,0,2,0,2,4,6,0,0,1,2,8,12
2009,J.R. Smith,SG,23,DEN,16,0,435,88,194,0.454,38,106,0.358,50,88,0.568,0.552,25,46,0.543,11,42,53,45,17,4,26,51,239
2009,Joe Smith,C,33,CLE,13,0,218,23,50,0.46,3,5,0.6,20,45,0.444,0.49,23,29,0.793,10,38,48,3,6,7,7,25,72
2009,Josh Smith,PF,23,ATL,11,11,410,67,159,0.421,2,15,0.133,65,144,0.451,0.428,52,71,0.732,24,58,82,24,12,17,21,36,188
2009,Marreese Speights,C,21,PHI,3,0,29,3,7,0.429,0,0,0,3,7,0.429,0.429,3,4,0.75,3,3,6,0,0,0,0,5,9
2009,Peja Stojakovic,SF,31,NOH,5,5,162,18,49,0.367,8,26,0.308,10,23,0.435,0.449,12,13,0.923,4,10,14,2,4,1,6,17,56
2009,Rodney Stuckey,PG,22,DET,4,4,128,24,61,0.393,0,8,0,24,53,0.453,0.393,12,14,0.857,2,7,9,21,0,0,6,9,60
2009,Wally Szczerbiak,SF,31,CLE,12,0,154,16,36,0.444,2,12,0.167,14,24,0.583,0.472,9,11,0.818,8,20,28,7,2,1,9,19,43
2009,Jason Terry,SG,31,DAL,10,1,325,49,126,0.389,22,59,0.373,27,67,0.403,0.476,23,30,0.767,6,22,28,19,6,3,16,18,143
2009,Kurt Thomas,PF,36,SAS,5,0,80,5,11,0.455,0,0,0,5,11,0.455,0.455,3,4,0.75,4,19,23,2,1,2,4,13,13
2009,Tim Thomas,PF,31,CHI,2,0,15,3,10,0.3,1,4,0.25,2,6,0.333,0.35,0,0,0,0,3,3,0,0,0,1,4,7
2009,Tyrus Thomas,PF,22,CHI,7,7,195,28,64,0.438,0,1,0,28,63,0.444,0.438,11,14,0.786,8,36,44,6,7,20,11,23,67
2009,Hedo Turkoglu,SF,29,ORL,24,24,934,126,295,0.427,32,83,0.386,94,212,0.443,0.481,94,115,0.817,9,100,109,116,18,4,64,80,378
2009,Ime Udoka,SF,31,SAS,5,0,104,7,20,0.35,1,8,0.125,6,12,0.5,0.375,2,5,0.4,8,15,23,4,4,1,2,14,17
2009,Anderson Varejao,PF,26,CLE,14,14,420,41,82,0.5,0,0,0,41,82,0.5,0.5,15,22,0.682,41,49,90,8,18,16,15,49,97
2009,Jacque Vaughn,PG,33,SAS,2,0,21,2,5,0.4,0,0,0,2,5,0.4,0.4,3,6,0.5,0,0,0,4,1,0,0,0,7
2009,Sasha Vujacic,SG,24,LAL,23,0,250,24,91,0.264,16,51,0.314,8,40,0.2,0.352,5,6,0.833,7,25,32,12,10,4,10,34,69
2009,Dwyane Wade,SG,27,MIA,7,7,285,68,155,0.439,18,50,0.36,50,105,0.476,0.497,50,58,0.862,4,31,35,37,6,11,25,20,204
2009,Von Wafer,SG,23,HOU,13,0,181,39,92,0.424,9,22,0.409,30,70,0.429,0.473,19,22,0.864,0,12,12,9,2,1,11,11,106
2009,Henry Walker,SF,21,BOS,4,0,10,0,2,0,0,0,0,0,2,0,0,2,2,1,0,0,0,0,2,0,2,2,2
2009,Ben Wallace,PF,34,CLE,14,0,176,8,13,0.615,0,0,0,8,13,0.615,0.615,0,6,0,18,20,38,4,4,4,3,13,16
2009,Rasheed Wallace,C,34,DET,4,4,122,11,30,0.367,4,8,0.5,7,22,0.318,0.433,0,0,0,2,23,25,3,2,1,3,12,26
2009,Luke Walton,SF,28,LAL,21,0,332,32,75,0.427,5,16,0.313,27,59,0.458,0.46,11,18,0.611,16,36,52,45,14,3,20,41,80
2009,David West,PF,28,NOH,5,5,178,32,80,0.4,0,0,0,32,80,0.4,0.4,26,29,0.897,5,32,37,6,5,2,14,19,90
2009,Delonte West,SG,25,CLE,14,14,591,73,157,0.465,12,36,0.333,61,121,0.504,0.503,35,42,0.833,6,43,49,58,19,7,34,28,193
2009,Mario West,SG,24,ATL,11,0,46,2,10,0.2,0,1,0,2,9,0.222,0.2,1,4,0.25,0,5,5,2,2,0,1,2,5
2009,James White,SF,26,HOU,5,0,12,3,9,0.333,1,2,0.5,2,7,0.286,0.389,0,0,0,1,0,1,0,0,0,1,0,7
2009,Deron Williams,PG,24,UTA,5,5,211,29,70,0.414,9,25,0.36,20,45,0.444,0.479,34,41,0.829,4,15,19,54,9,2,21,17,101
2009,Lou Williams,SG,22,PHI,6,0,149,21,51,0.412,6,16,0.375,15,35,0.429,0.471,10,15,0.667,2,13,15,17,3,1,12,10,58
2009,Marvin Williams,SF,22,ATL,6,3,97,10,29,0.345,1,6,0.167,9,23,0.391,0.362,9,13,0.692,3,6,9,6,5,2,6,8,30
2009,Mo Williams,PG,26,CLE,14,14,541,80,196,0.408,35,94,0.372,45,102,0.441,0.497,33,43,0.767,9,36,45,58,10,1,30,43,228
2009,Metta World Peace,SF,29,HOU,13,13,488,80,203,0.394,23,83,0.277,57,120,0.475,0.451,20,28,0.714,12,44,56,54,14,3,32,27,203
2009,Antoine Wright,SF,24,DAL,10,5,167,21,43,0.488,8,21,0.381,13,22,0.591,0.581,9,11,0.818,5,8,13,10,3,2,4,30,59
2009,Dorell Wright,SF,23,MIA,1,0,3,0,0,,0,0,0,0,0,0,,0,0,0,0,0,0,0,0,0,0,0,0
2009,Julian Wright,SF,21,NOH,4,0,32,3,7,0.429,0,0,0,3,7,0.429,0.429,2,4,0.5,0,6,6,2,0,1,1,6,8
2009,Thaddeus Young,PF,20,PHI,6,6,229,31,70,0.443,5,12,0.417,26,58,0.448,0.479,5,6,0.833,9,18,27,8,6,1,8,17,72
2010,Arron Afflalo,SG,24,DEN,6,6,120,20,32,0.625,6,14,0.429,14,18,0.778,0.719,9,11,0.818,1,11,12,7,1,2,4,21,55
2010,LaMarcus Aldridge,PF,24,POR,6,6,229,40,93,0.43,1,2,0.5,39,91,0.429,0.435,33,44,0.75,10,26,36,13,7,11,11,16,114
2010,Malik Allen,PF,31,DEN,4,0,11,0,1,0,0,0,0,0,1,0,0,0,0,0,2,1,3,0,1,0,0,2,0
2010,Ray Allen*,SG,34,BOS,24,24,925,131,304,0.431,56,145,0.386,75,159,0.472,0.523,69,80,0.863,12,68,80,63,22,3,36,74,387
2010,Tony Allen,SG,28,BOS,24,0,391,47,98,0.48,0,5,0,47,93,0.505,0.48,28,36,0.778,13,28,41,17,25,14,23,58,122
2010,Lou Amundson,PF,27,PHO,16,0,194,19,36,0.528,0,0,0,19,36,0.528,0.528,9,21,0.429,30,26,56,1,6,7,6,31,47
2010,Chris Andersen,PF,31,DEN,6,0,116,9,17,0.529,0,0,0,9,17,0.529,0.529,9,14,0.643,7,20,27,1,1,6,4,14,27
2010,Ryan Anderson,PF,21,ORL,9,0,89,9,29,0.31,4,14,0.286,5,15,0.333,0.379,1,1,1,8,23,31,3,2,2,5,12,23
2010,Carmelo Anthony,SF,25,DEN,6,6,254,64,138,0.464,6,19,0.316,58,119,0.487,0.486,50,57,0.877,14,37,51,20,12,3,21,26,184
2010,Joel Anthony,C,27,MIA,5,0,79,5,7,0.714,0,0,0,5,7,0.714,0.714,3,4,0.75,6,3,9,1,2,5,1,9,13
2010,Carlos Arroyo,PG,30,MIA,5,5,115,12,26,0.462,0,1,0,12,25,0.48,0.462,2,2,1,2,7,9,11,3,0,3,9,26
2010,D.J. Augustin,PG,22,CHA,4,0,73,5,17,0.294,2,6,0.333,3,11,0.273,0.353,5,6,0.833,1,3,4,7,1,1,4,4,17
2010,Jeff Ayres,C,22,POR,3,0,17,2,4,0.5,0,0,0,2,4,0.5,0.5,3,4,0.75,2,0,2,0,2,3,1,1,7
2010,Leandro Barbosa,PG,27,PHO,16,0,250,43,103,0.417,12,35,0.343,31,68,0.456,0.476,17,24,0.708,2,19,21,20,5,2,15,33,115
2010,J.J. Barea,PG,25,DAL,6,0,105,15,37,0.405,4,10,0.4,11,27,0.407,0.459,1,3,0.333,4,8,12,15,2,1,10,13,35
2010,Matt Barnes,SF,29,ORL,14,14,326,30,75,0.4,12,32,0.375,18,43,0.419,0.48,17,20,0.85,16,50,66,19,10,3,10,28,89
2010,Brandon Bass,PF,24,ORL,7,0,42,7,13,0.538,0,0,0,7,13,0.538,0.538,5,6,0.833,2,6,8,1,0,0,1,2,19
2010,Nicolas Batum,SF,21,POR,6,6,139,17,37,0.459,9,21,0.429,8,16,0.5,0.581,6,8,0.75,4,15,19,5,2,0,4,13,49
2010,Jerryd Bayless,SG,21,POR,6,2,166,28,65,0.431,6,15,0.4,22,50,0.44,0.477,19,24,0.792,4,12,16,23,2,0,8,21,81
2010,Michael Beasley,PF,21,MIA,5,5,135,22,49,0.449,1,2,0.5,21,47,0.447,0.459,7,9,0.778,10,19,29,3,4,0,13,10,52
2010,Rodrigue Beaubois,PG,21,DAL,4,0,31,9,19,0.474,2,6,0.333,7,13,0.538,0.526,1,3,0.333,2,4,6,4,0,0,3,5,21
2010,Charlie Bell,SG,30,MIL,3,0,8,0,2,0,0,1,0,0,1,0,0,0,0,0,0,0,0,0,0,0,0,2,0
2010,Mike Bibby,PG,31,ATL,11,11,292,36,80,0.45,14,34,0.412,22,46,0.478,0.538,7,10,0.7,5,23,28,28,9,0,12,26,93
2010,Chauncey Billups,PG,33,DEN,6,6,207,37,83,0.446,11,31,0.355,26,52,0.5,0.512,37,42,0.881,1,13,14,38,6,3,18,24,122
2010,DeJuan Blair,PF,20,SAS,10,0,91,16,32,0.5,0,0,0,16,32,0.5,0.5,5,9,0.556,19,20,39,5,5,4,2,18,37
2010,Keith Bogans,SF,29,SAS,8,0,55,2,10,0.2,1,6,0.167,1,4,0.25,0.25,0,0,0,1,5,6,2,2,1,2,9,5
2010,Matt Bonner,PF,29,SAS,10,0,173,19,44,0.432,10,27,0.37,9,17,0.529,0.545,2,2,1,7,25,32,4,1,3,7,22,50
2010,Carlos Boozer,PF,28,UTA,10,10,402,89,168,0.53,0,0,0,89,168,0.53,0.53,19,35,0.543,33,99,132,30,4,7,24,38,197
2010,Primoz Brezec,C,30,MIL,4,0,25,4,7,0.571,0,0,0,4,7,0.571,0.571,1,2,0.5,1,2,3,0,1,0,0,5,9
2010,Derrick Brown,SF,22,CHA,2,0,1,1,1,1,0,0,0,1,1,1,1,0,0,0,0,0,0,0,0,0,0,0,2
2010,Devin Brown,SG,31,CHI,1,0,2,1,1,1,0,0,0,1,1,1,1,0,1,0,0,1,1,0,0,0,0,0,2
2010,Shannon Brown,SG,24,LAL,23,0,324,42,107,0.393,9,32,0.281,33,75,0.44,0.435,20,28,0.714,7,22,29,20,10,7,13,37,113
2010,Kobe Bryant,SG,31,LAL,23,23,923,234,511,0.458,49,131,0.374,185,380,0.487,0.506,154,183,0.842,26,112,138,126,31,16,79,75,671
2010,Caron Butler,SG,29,DAL,6,6,202,43,99,0.434,7,23,0.304,36,76,0.474,0.47,25,27,0.926,3,32,35,8,9,5,15,16,118
2010,Andrew Bynum,C,22,LAL,23,23,561,80,149,0.537,0,0,0,80,149,0.537,0.537,38,56,0.679,59,100,159,12,6,36,21,61,198
2010,Marcus Camby,C,35,POR,6,6,178,16,38,0.421,0,1,0,16,37,0.432,0.421,3,6,0.5,16,44,60,14,4,7,3,18,35
2010,Matt Carroll,SG,29,DAL,1,0,5,1,1,1,0,0,0,1,1,1,1,0,0,0,0,1,1,0,0,0,0,0,2
2010,Anthony Carter,PG,34,DEN,1,0,7,0,1,0,0,0,0,0,1,0,0,0,0,0,0,0,0,3,0,0,0,0,0
2010,Vince Carter,SG,33,ORL,14,14,480,74,184,0.402,12,51,0.235,62,133,0.466,0.435,57,69,0.826,9,50,59,32,12,3,22,50,217
2010,Mario Chalmers,PG,23,MIA,5,0,131,18,40,0.45,7,20,0.35,11,20,0.55,0.538,11,13,0.846,1,8,9,13,3,0,12,18,54
2010,Tyson Chandler,C,27,CHA,4,0,60,6,11,0.545,0,0,0,6,11,0.545,0.545,2,3,0.667,3,7,10,2,2,3,4,16,14
2010,Earl Clark,PF,22,PHO,3,0,13,1,3,0.333,0,0,0,1,3,0.333,0.333,2,2,1,0,2,2,1,1,0,2,1,4
2010,Jarron Collins,C,31,PHO,11,10,115,5,15,0.333,0,0,0,5,15,0.333,0.333,2,2,1,9,8,17,0,1,1,3,22,12
2010,Jason Collins,C,31,ATL,3,0,10,3,5,0.6,0,0,0,3,5,0.6,0.6,0,0,0,3,2,5,0,0,0,1,7,6
2010,Nick Collison,C,29,OKC,6,0,129,8,24,0.333,0,1,0,8,23,0.348,0.333,3,7,0.429,12,16,28,2,5,1,4,20,19
2010,Jamal Crawford,SG,29,ATL,11,0,351,56,154,0.364,18,50,0.36,38,104,0.365,0.422,49,58,0.845,1,29,30,30,9,1,20,26,179
2010,Dante Cunningham,PF,22,POR,5,0,42,9,15,0.6,0,1,0,9,14,0.643,0.6,5,6,0.833,5,8,13,0,5,0,3,10,23
2010,Erick Dampier,C,34,DAL,5,4,118,0,8,0,0,0,0,0,8,0,0,5,12,0.417,18,15,33,3,1,5,6,19,5
2010,Marquis Daniels,SF,29,BOS,11,0,37,5,13,0.385,1,2,0.5,4,11,0.364,0.423,6,6,1,5,5,10,1,0,0,3,4,17
2010,Glen Davis,PF,24,BOS,24,1,483,59,124,0.476,0,3,0,59,121,0.488,0.476,57,79,0.722,39,70,109,10,19,9,22,54,175
2010,Carlos Delfino,SF,27,MIL,7,7,226,26,73,0.356,15,37,0.405,11,36,0.306,0.459,3,4,0.75,3,25,28,18,5,2,12,14,70
2010,Luol Deng,SF,24,CHI,5,5,203,37,80,0.463,1,12,0.083,36,68,0.529,0.469,19,26,0.731,8,17,25,7,6,4,3,15,94
2010,Boris Diaw,PF,27,CHA,4,4,152,14,28,0.5,1,9,0.111,13,19,0.684,0.518,1,2,0.5,7,13,20,16,1,3,12,11,30
2010,Travis Diener,PG,27,POR,2,0,7,0,0,,0,0,0,0,0,0,,0,0,0,0,0,0,2,0,0,0,0,0
2010,Goran Dragic,PG,23,PHO,16,0,237,43,100,0.43,13,40,0.325,30,60,0.5,0.495,23,31,0.742,10,19,29,36,4,1,16,18,122
2010,Jared Dudley,SF,24,PHO,16,0,377,40,86,0.465,25,59,0.424,15,27,0.556,0.61,17,28,0.607,15,45,60,28,18,6,9,37,122
2010,Tim Duncan,C,33,SAS,10,10,373,78,150,0.52,1,2,0.5,77,148,0.52,0.523,33,69,0.478,30,69,99,26,8,17,24,27,190
2010,Kevin Durant,SF,21,OKC,6,6,231,43,123,0.35,10,35,0.286,33,88,0.375,0.39,54,62,0.871,8,38,46,14,3,8,22,17,150
2010,Maurice Evans,SF,31,ATL,11,0,148,11,37,0.297,3,10,0.3,8,27,0.296,0.338,0,0,0,4,9,13,2,9,0,5,19,25
2010,Jordan Farmar,PG,23,LAL,23,0,301,38,94,0.404,20,50,0.4,18,44,0.409,0.511,9,13,0.692,1,26,27,32,17,0,20,30,105
2010,Raymond Felton,PG,25,CHA,4,4,130,17,42,0.405,4,13,0.308,13,29,0.448,0.452,9,12,0.75,3,7,10,20,2,0,6,8,47
2010,Rudy Fernandez,SG,24,POR,6,3,119,12,27,0.444,11,23,0.478,1,4,0.25,0.648,6,8,0.75,2,8,10,8,1,0,5,7,41
2010,Kyrylo Fesenko,C,23,UTA,10,9,181,13,30,0.433,0,0,0,13,30,0.433,0.433,7,21,0.333,8,31,39,12,0,5,14,30,33
2010,Michael Finley,SF,36,BOS,18,0,108,5,20,0.25,3,11,0.273,2,9,0.222,0.325,2,2,1,1,10,11,4,4,0,0,4,15
2010,Derek Fisher,PG,35,LAL,23,23,754,82,183,0.448,27,75,0.36,55,108,0.509,0.522,46,56,0.821,9,49,58,64,28,1,36,83,237
2010,Channing Frye,C,26,PHO,16,0,435,43,118,0.364,30,86,0.349,13,32,0.406,0.492,15,16,0.938,10,80,90,15,12,9,8,50,131
2010,Dan Gadzuric,C,31,MIL,7,0,76,9,17,0.529,0,0,0,9,17,0.529,0.529,1,4,0.25,10,14,24,1,1,5,6,15,19
2010,Sundiata Gaines,PG,23,UTA,5,0,7,5,6,0.833,1,1,1,4,5,0.8,0.917,0,2,0,1,1,2,0,0,0,0,1,11
2010,Kevin Garnett,PF,33,BOS,23,23,766,149,301,0.495,0,2,0,149,299,0.498,0.495,47,56,0.839,32,138,170,58,26,20,31,74,345
2010,Pau Gasol,C,29,LAL,23,23,913,165,306,0.539,0,3,0,165,303,0.545,0.539,120,158,0.759,92,163,255,81,9,48,44,63,450
2010,Daniel Gibson,PG,23,CLE,5,0,23,2,7,0.286,1,4,0.25,1,3,0.333,0.357,2,2,1,0,3,3,1,0,0,2,3,7
2010,Taj Gibson,PF,24,CHI,5,5,145,16,38,0.421,0,0,0,16,38,0.421,0.421,6,11,0.545,9,26,35,3,1,3,2,17,38
2010,Manu Ginobili,SG,32,SAS,10,10,352,58,140,0.414,20,60,0.333,38,80,0.475,0.486,58,67,0.866,4,33,37,60,26,2,30,30,194
2010,Marcin Gortat,C,25,ORL,14,0,212,17,26,0.654,0,0,0,17,26,0.654,0.654,8,11,0.727,24,38,62,9,3,4,3,29,42
2010,Joey Graham,SF,27,DEN,4,0,29,10,17,0.588,1,3,0.333,9,14,0.643,0.618,3,5,0.6,4,6,10,0,2,1,1,6,24
2010,Stephen Graham,SG,27,CHA,2,0,5,0,4,0,0,1,0,0,3,0,0,0,0,0,0,0,0,1,1,0,1,1,0
2010,Jeff Green,PF,23,OKC,6,6,224,23,70,0.329,8,27,0.296,15,43,0.349,0.386,17,20,0.85,6,22,28,10,4,3,6,16,71
2010,James Harden,SG,20,OKC,6,0,120,12,31,0.387,6,16,0.375,6,15,0.4,0.484,16,19,0.842,1,14,15,11,6,1,3,14,46
2010,Udonis Haslem,PF,29,MIA,5,0,142,13,37,0.351,0,0,0,13,37,0.351,0.351,4,6,0.667,9,28,37,4,1,1,5,18,30
2010,Brendan Haywood,C,30,DAL,6,2,139,12,21,0.571,0,0,0,12,21,0.571,0.571,12,20,0.6,18,19,37,3,7,10,3,14,36
2010,J.J. Hickson,PF,21,CLE,11,0,79,14,22,0.636,0,0,0,14,22,0.636,0.636,11,16,0.688,1,8,9,1,0,0,6,9,39
2010,Nene Hilario,C,27,DEN,5,5,169,18,29,0.621,0,0,0,18,29,0.621,0.621,21,36,0.583,8,21,29,11,6,1,4,17,57
2010,George Hill,PG,23,SAS,10,8,344,46,102,0.451,11,29,0.379,35,73,0.479,0.505,31,37,0.838,5,26,31,7,10,2,8,21,134
2010,Grant Hill*,SF,37,PHO,16,16,452,59,123,0.48,3,16,0.188,56,107,0.523,0.492,33,38,0.868,12,81,93,36,13,10,19,46,154
2010,Kirk Hinrich,SG,29,CHI,5,5,196,22,52,0.423,8,16,0.5,14,36,0.389,0.5,10,14,0.714,1,21,22,20,7,0,2,14,62
2010,Al Horford,C,23,ATL,11,11,388,67,128,0.523,1,1,1,66,127,0.52,0.527,26,31,0.839,28,71,99,20,8,19,15,35,161
2010,Dwight Howard,C,24,ORL,14,14,497,86,140,0.614,0,0,0,86,140,0.614,0.614,82,158,0.519,38,117,155,19,11,49,51,59,254
2010,Juwan Howard,C,36,POR,6,0,87,10,19,0.526,0,0,0,10,19,0.526,0.526,0,0,0,8,8,16,4,1,1,3,20,20
2010,Larry Hughes,SG,31,CHA,4,0,58,8,17,0.471,4,10,0.4,4,7,0.571,0.588,4,7,0.571,1,12,13,6,0,0,3,8,24
2010,Serge Ibaka,PF,20,OKC,6,0,153,20,35,0.571,0,0,0,20,35,0.571,0.571,7,10,0.7,13,26,39,2,2,12,6,19,47
2010,Zydrunas Ilgauskas,C,34,CLE,7,0,69,5,13,0.385,0,0,0,5,13,0.385,0.385,2,3,0.667,7,4,11,3,0,7,1,10,12
2010,Didier Ilunga-Mbenga,C,29,LAL,3,0,12,2,6,0.333,0,0,0,2,6,0.333,0.333,1,1,1,0,5,5,1,0,0,0,2,5
2010,Ersan Ilyasova,PF,22,MIL,7,0,157,24,50,0.48,5,14,0.357,19,36,0.528,0.53,15,18,0.833,21,32,53,3,5,1,10,14,68
2010,Royal Ivey,SG,28,MIL,3,0,11,2,6,0.333,0,2,0,2,4,0.5,0.333,0,0,0,0,0,0,2,0,1,1,1,4
2010,Stephen Jackson,SG,31,CHA,4,4,156,24,67,0.358,3,18,0.167,21,49,0.429,0.381,21,26,0.808,6,14,20,15,5,1,17,13,72
2010,LeBron James,SF,25,CLE,11,11,460,106,211,0.502,20,50,0.4,86,161,0.534,0.55,88,120,0.733,15,87,102,84,19,20,42,23,320
2010,Antawn Jamison,PF,33,CLE,11,11,375,64,137,0.467,10,39,0.256,54,98,0.551,0.504,30,41,0.732,16,65,81,14,7,11,18,38,168
2010,Othyus Jeffers,SG,24,UTA,6,0,10,1,6,0.167,0,0,0,1,6,0.167,0.167,0,1,0,1,0,1,0,0,0,1,0,2
2010,Richard Jefferson,SF,29,SAS,10,10,334,34,70,0.486,1,5,0.2,33,65,0.508,0.493,25,33,0.758,8,45,53,18,6,6,15,20,94
2010,Brandon Jennings,PG,20,MIL,7,7,249,49,120,0.408,12,41,0.293,37,79,0.468,0.458,21,26,0.808,5,16,21,25,8,4,8,19,131
2010,Anthony Johnson,PG,35,ORL,1,0,5,1,2,0.5,0,1,0,1,1,1,0.5,0,0,0,0,0,0,2,0,0,0,0,2
2010,James Johnson,PF,22,CHI,4,0,20,0,2,0,0,1,0,0,1,0,0,0,0,0,1,0,1,1,0,0,2,11,0
2010,Joe Johnson,SG,28,ATL,11,11,440,77,199,0.387,9,41,0.22,68,158,0.43,0.41,34,42,0.81,20,36,56,55,10,3,25,22,197
2010,Dwayne Jones,PF,26,PHO,2,0,10,1,2,0.5,0,0,0,1,2,0.5,0.5,3,4,0.75,1,4,5,0,0,0,1,0,5
2010,James Jones,SF,29,MIA,1,0,9,0,1,0,0,1,0,0,0,0,0,2,2,1,0,0,0,0,0,0,1,1,2
2010,Jason Kidd*,PG,36,DAL,6,6,243,14,46,0.304,9,28,0.321,5,18,0.278,0.402,11,12,0.917,6,35,41,42,14,1,9,15,48
2010,Andrei Kirilenko,SF,28,UTA,2,0,30,5,10,0.5,0,1,0,5,9,0.556,0.5,1,1,1,3,3,6,0,1,1,0,2,11
2010,Kyle Korver,SG,28,UTA,10,0,210,32,61,0.525,11,23,0.478,21,38,0.553,0.615,8,9,0.889,0,11,11,13,5,0,7,22,83
2010,Kosta Koufos,C,20,UTA,9,0,31,4,10,0.4,0,0,0,4,10,0.4,0.4,0,0,0,4,5,9,0,0,1,2,2,8
2010,Nenad Krstic,C,26,OKC,6,6,129,15,37,0.405,0,0,0,15,37,0.405,0.405,13,14,0.929,15,20,35,4,3,4,5,15,43
2010,Ty Lawson,PG,22,DEN,6,0,118,15,35,0.429,4,10,0.4,11,25,0.44,0.486,13,19,0.684,4,4,8,16,6,0,8,18,47
2010,Rashard Lewis,PF,30,ORL,14,14,512,66,143,0.462,28,75,0.373,38,68,0.559,0.559,20,25,0.8,15,64,79,32,15,10,25,38,180
2010,Robin Lopez,C,21,PHO,6,6,104,19,35,0.543,0,0,0,19,35,0.543,0.543,9,9,1,12,12,24,0,2,1,3,11,47
2010,Jamaal Magloire,C,31,MIA,1,0,5,0,2,0,0,0,0,0,2,0,0,0,0,0,0,1,1,0,0,0,1,1,0
2010,Ian Mahinmi,C,23,SAS,2,0,19,3,6,0.5,0,0,0,3,6,0.5,0.5,3,4,0.75,0,2,2,0,0,1,2,3,9
2010,Shawn Marion,SF,31,DAL,6,6,148,24,59,0.407,0,4,0,24,55,0.436,0.407,4,5,0.8,7,18,25,6,1,3,8,12,52
2010,Kenyon Martin,PF,32,DEN,6,6,205,24,50,0.48,0,1,0,24,49,0.49,0.48,12,19,0.632,14,36,50,8,9,7,11,27,60
2010,Roger Mason,SG,29,SAS,6,0,61,1,12,0.083,1,7,0.143,0,5,0,0.125,0,0,0,0,4,4,2,1,0,2,12,3
2010,Wesley Matthews,SG,23,UTA,10,10,371,39,101,0.386,15,42,0.357,24,59,0.407,0.46,39,48,0.813,10,34,44,17,18,5,15,34,132
2010,Eric Maynor,PG,22,OKC,6,0,76,6,20,0.3,1,6,0.167,5,14,0.357,0.325,9,11,0.818,1,8,9,9,1,1,5,5,22
2010,Luc Mbah a Moute,PF,23,MIL,7,7,178,26,50,0.52,0,2,0,26,48,0.542,0.52,12,20,0.6,14,25,39,5,2,0,7,15,64
2010,Antonio McDyess,PF,35,SAS,10,10,247,33,62,0.532,0,0,0,33,62,0.532,0.532,2,2,1,18,50,68,12,2,7,9,27,68
2010,C.J. Miles,SF,22,UTA,10,10,337,47,106,0.443,15,46,0.326,32,60,0.533,0.514,35,39,0.897,5,20,25,28,6,6,19,48,144
2010,Andre Miller,PG,33,POR,6,6,210,30,74,0.405,3,7,0.429,27,67,0.403,0.426,31,40,0.775,5,14,19,36,7,1,19,12,94
2010,Brad Miller,C,33,CHI,5,0,93,10,27,0.37,0,4,0,10,23,0.435,0.37,7,7,1,3,15,18,4,0,1,7,16,27
2010,Patty Mills,PG,21,POR,3,0,12,2,4,0.5,1,1,1,1,3,0.333,0.625,1,1,1,0,0,0,3,0,0,1,1,6
2010,Paul Millsap,PF,24,UTA,10,0,323,70,122,0.574,0,2,0,70,120,0.583,0.574,40,58,0.69,34,54,88,22,11,14,13,36,180
2010,Nazr Mohammed,C,32,CHA,4,0,48,11,19,0.579,0,0,0,11,19,0.579,0.579,2,3,0.667,5,3,8,2,1,2,1,13,24
2010,Jamario Moon,SF,29,CLE,11,0,113,14,24,0.583,8,16,0.5,6,8,0.75,0.75,2,3,0.667,2,14,16,5,4,5,0,8,38
2010,Randolph Morris,PF,24,ATL,3,0,10,1,2,0.5,0,0,0,1,2,0.5,0.5,1,1,1,1,1,2,0,0,0,0,3,3
2010,Adam Morrison,SF,25,LAL,2,0,13,4,9,0.444,0,2,0,4,7,0.571,0.444,0,0,0,2,3,5,1,0,0,0,2,8
2010,Byron Mullens,PF,20,OKC,1,0,4,0,2,0,0,0,0,0,2,0,0,1,2,0.5,0,0,0,0,0,0,0,0,1
2010,Ronald Murray,SG,30,CHI,5,0,97,15,37,0.405,4,12,0.333,11,25,0.44,0.459,8,8,1,4,9,13,10,2,0,1,3,42
2010,Eduardo Najera,PF,33,DAL,5,0,36,2,8,0.25,0,5,0,2,3,0.667,0.25,0,0,0,5,4,9,0,2,0,1,8,4
2010,Steve Nash*,PG,35,PHO,16,16,539,99,191,0.518,19,50,0.38,80,141,0.567,0.568,67,75,0.893,6,46,52,161,4,1,60,20,284
2010,Jameer Nelson,PG,27,ORL,14,14,479,91,190,0.479,33,84,0.393,58,106,0.547,0.566,51,62,0.823,9,41,50,67,14,0,35,38,266
2010,Joakim Noah,C,24,CHI,5,5,188,28,53,0.528,0,0,0,28,53,0.528,0.528,18,19,0.947,20,45,65,13,9,7,15,20,74
2010,Dirk Nowitzki,PF,31,DAL,6,6,233,58,106,0.547,4,7,0.571,54,99,0.545,0.566,40,42,0.952,7,42,49,18,5,4,10,15,160
2010,Jermaine O'Neal,C,31,MIA,5,5,117,9,44,0.205,0,0,0,9,44,0.205,0.205,3,7,0.429,10,18,28,5,4,10,7,13,21
2010,Shaquille O'Neal*,C,37,CLE,11,11,243,48,93,0.516,0,0,0,48,93,0.516,0.516,31,47,0.66,21,40,61,15,2,13,24,41,127
2010,Lamar Odom,PF,30,LAL,23,0,667,91,194,0.469,10,41,0.244,81,153,0.529,0.495,30,50,0.6,60,138,198,46,15,21,28,84,222
2010,Mehmet Okur,C,30,UTA,1,1,11,2,2,1,1,1,1,1,1,1,1.25,2,2,1,1,1,2,0,0,0,1,0,7
2010,Kevin Ollie,PG,37,OKC,1,0,5,0,1,0,0,0,0,0,1,0,0,0,0,0,0,0,0,0,0,0,0,0,0
2010,Zaza Pachulia,C,25,ATL,11,0,161,18,35,0.514,0,0,0,18,35,0.514,0.514,15,24,0.625,19,19,38,3,2,7,9,34,51
2010,Jannero Pargo,PG,30,CHI,2,0,8,1,5,0.2,1,2,0.5,0,3,0,0.3,0,0,0,0,0,0,1,0,0,0,0,3
2010,Anthony Parker,SG,34,CLE,11,11,331,30,64,0.469,20,44,0.455,10,20,0.5,0.625,11,15,0.733,1,25,26,14,9,3,11,16,91
2010,Tony Parker,PG,27,SAS,10,2,335,73,154,0.474,2,3,0.667,71,151,0.47,0.481,25,42,0.595,9,29,38,54,6,0,22,20,173
2010,Kendrick Perkins,C,25,BOS,23,23,575,49,96,0.51,0,1,0,49,95,0.516,0.51,33,55,0.6,41,102,143,22,9,32,43,79,131
2010,Johan Petro,C,24,DEN,6,1,45,6,11,0.545,0,0,0,6,11,0.545,0.545,1,2,0.5,2,9,11,1,1,3,3,13,13
2010,Paul Pierce,SF,32,BOS,24,24,930,147,336,0.438,40,102,0.392,107,234,0.457,0.497,117,142,0.824,20,123,143,82,24,14,64,80,451
2010,Mickael Pietrus,SF,27,ORL,14,0,282,35,80,0.438,28,61,0.459,7,19,0.368,0.613,20,30,0.667,2,18,20,10,9,6,6,27,118
2010,Leon Powe,SF,26,CLE,3,0,9,1,4,0.25,0,0,0,1,4,0.25,0.25,3,4,0.75,1,1,2,0,0,0,1,3,5
2010,Josh Powell,PF,27,LAL,13,0,40,3,8,0.375,0,1,0,3,7,0.429,0.375,3,4,0.75,2,4,6,1,0,0,1,9,9
2010,Ronnie Price,PG,26,UTA,10,0,90,7,24,0.292,2,7,0.286,5,17,0.294,0.333,4,8,0.5,5,5,10,14,4,1,2,20,20
2010,Theo Ratliff,C,36,CHA,4,4,47,3,8,0.375,0,0,0,3,8,0.375,0.375,1,2,0.5,0,3,3,1,2,0,2,15,7
2010,J.J. Redick,SG,25,ORL,14,0,269,30,71,0.423,15,35,0.429,15,36,0.417,0.528,30,35,0.857,4,20,24,19,10,0,20,22,105
2010,Chris Richard,PF,25,CHI,2,0,5,0,0,,0,0,0,0,0,0,,0,0,0,1,2,3,0,0,0,0,0,0
2010,Jason Richardson,SG,29,PHO,16,16,533,112,223,0.502,48,101,0.475,64,122,0.525,0.61,44,58,0.759,18,69,87,17,17,4,10,35,316
2010,Quentin Richardson,SF,29,MIA,5,5,149,18,45,0.4,9,22,0.409,9,23,0.391,0.5,4,5,0.8,1,18,19,8,8,1,5,16,49
2010,Luke Ridnour,PG,28,MIL,7,0,121,21,45,0.467,5,14,0.357,16,31,0.516,0.522,10,12,0.833,4,9,13,13,4,1,10,13,57
2010,Nate Robinson,PG,25,BOS,17,0,128,24,64,0.375,11,33,0.333,13,31,0.419,0.461,12,15,0.8,4,10,14,18,6,1,7,16,71
2010,Rajon Rondo,PG,23,BOS,24,24,975,151,326,0.463,9,24,0.375,142,302,0.47,0.477,68,114,0.596,38,96,134,223,46,3,72,57,379
2010,Derrick Rose,PG,21,CHI,5,5,212,57,125,0.456,2,6,0.333,55,119,0.462,0.464,18,22,0.818,4,13,17,36,4,0,13,8,134
2010,Brandon Roy,SG,25,POR,3,1,83,10,33,0.303,2,12,0.167,8,21,0.381,0.333,7,9,0.778,2,5,7,5,0,0,3,7,29
2010,John Salmons,SG,30,MIL,7,7,285,44,109,0.404,4,23,0.174,40,86,0.465,0.422,27,28,0.964,7,19,26,28,10,4,12,19,119
2010,Brian Scalabrine,PF,31,BOS,1,0,1,0,0,,0,0,0,0,0,0,,0,0,0,0,0,0,0,0,0,0,0,0
2010,Thabo Sefolosha,SG,25,OKC,6,6,127,8,27,0.296,3,13,0.231,5,14,0.357,0.352,8,9,0.889,3,15,18,7,5,6,2,15,27
2010,J.R. Smith,SG,24,DEN,6,0,159,21,57,0.368,11,31,0.355,10,26,0.385,0.465,14,16,0.875,5,18,23,10,4,2,6,17,67
2010,Joe Smith,PF,34,ATL,5,0,24,0,3,0,0,0,0,0,3,0,0,0,0,0,1,1,2,0,0,1,1,1,0
2010,Josh Smith,PF,24,ATL,11,11,392,62,129,0.481,2,6,0.333,60,123,0.488,0.488,29,44,0.659,37,62,99,29,13,19,17,30,155
2010,Jerry Stackhouse,SG,35,MIL,7,0,144,14,43,0.326,5,15,0.333,9,28,0.321,0.384,18,20,0.9,1,11,12,8,5,1,5,4,51
2010,DeShawn Stevenson,SG,28,DAL,2,0,6,0,3,0,0,3,0,0,0,0,0,0,0,0,0,0,0,0,0,0,0,2,0
2010,Amar'e Stoudemire,PF,27,PHO,16,16,584,124,239,0.519,0,4,0,124,235,0.528,0.519,107,142,0.754,46,60,106,18,11,24,40,54,355
2010,Jeff Teague,PG,21,ATL,9,0,59,7,21,0.333,2,5,0.4,5,16,0.313,0.381,0,0,0,0,2,2,4,3,1,4,3,16
2010,Garrett Temple,SG,23,SAS,6,0,15,1,3,0.333,1,3,0.333,0,0,0,0.5,1,1,1,0,2,2,2,1,0,2,1,4
2010,Jason Terry,SG,32,DAL,6,0,174,26,69,0.377,12,30,0.4,14,39,0.359,0.464,12,16,0.75,2,13,15,12,4,1,6,16,76
2010,Etan Thomas,C,31,OKC,2,0,17,5,6,0.833,0,0,0,5,6,0.833,0.833,2,2,1,1,3,4,0,0,0,1,1,12
2010,Kurt Thomas,C,37,MIL,7,7,199,17,35,0.486,0,0,0,17,35,0.486,0.486,4,5,0.8,12,43,55,11,3,4,8,26,38
2010,Tyrus Thomas,C,23,CHA,4,0,68,15,24,0.625,0,0,0,15,24,0.625,0.625,5,6,0.833,6,16,22,2,2,2,4,9,35
2010,Anderson Varejao,PF,27,CLE,11,0,255,20,48,0.417,0,1,0,20,47,0.426,0.417,23,31,0.742,22,49,71,7,11,9,12,38,63
2010,Sasha Vujacic,SG,25,LAL,10,0,76,10,23,0.435,6,15,0.4,4,8,0.5,0.565,5,6,0.833,3,5,8,5,2,0,3,8,31
2010,Dwyane Wade,SG,28,MIA,5,5,210,62,110,0.564,15,37,0.405,47,73,0.644,0.632,27,40,0.675,6,22,28,34,8,8,26,16,166
2010,Gerald Wallace,SF,27,CHA,4,4,164,21,44,0.477,5,11,0.455,16,33,0.485,0.534,23,35,0.657,2,34,36,9,5,6,3,9,70
2010,Rasheed Wallace,C,35,BOS,24,1,410,52,125,0.416,19,55,0.345,33,70,0.471,0.492,24,29,0.828,5,66,71,9,10,14,9,82,147
2010,Luke Walton,SF,29,LAL,16,0,96,7,23,0.304,2,9,0.222,5,14,0.357,0.348,2,4,0.5,0,8,8,14,1,2,4,13,18
2010,Hakim Warrick,PF,27,CHI,3,0,31,2,11,0.182,0,1,0,2,10,0.2,0.182,5,6,0.833,3,2,5,0,0,0,2,3,9
2010,Kyle Weaver,SG,23,OKC,1,0,12,1,4,0.25,0,1,0,1,3,0.333,0.25,0,0,0,0,2,2,2,0,0,0,2,2
2010,Martell Webster,SF,23,POR,6,0,152,22,52,0.423,5,17,0.294,17,35,0.486,0.471,10,18,0.556,7,19,26,4,5,3,3,13,59
2010,Delonte West,SG,26,CLE,11,0,269,28,67,0.418,3,19,0.158,25,48,0.521,0.44,15,16,0.938,6,15,21,29,9,3,19,16,74
2010,Mario West,SG,25,ATL,7,0,20,3,4,0.75,0,1,0,3,3,1,0.75,0,0,0,1,1,2,1,1,0,0,7,6
2010,Russell Westbrook,PG,21,OKC,6,6,212,43,91,0.473,5,12,0.417,38,79,0.481,0.5,32,38,0.842,10,26,36,36,10,1,14,13,123
2010,Deron Williams,PG,25,UTA,10,10,398,67,149,0.45,20,51,0.392,47,98,0.48,0.517,89,111,0.802,4,23,27,102,10,4,30,37,243
2010,Jason Williams,PG,34,ORL,14,0,192,13,38,0.342,6,24,0.25,7,14,0.5,0.421,5,5,1,3,8,11,23,4,0,5,8,37
2010,Jawad Williams,PG,26,CLE,3,0,4,0,2,0,0,2,0,0,0,0,0,0,0,0,0,0,0,0,0,0,0,1,0
2010,Marvin Williams,SF,23,ATL,11,11,345,31,79,0.392,1,2,0.5,30,77,0.39,0.399,29,32,0.906,23,40,63,8,6,5,5,20,92
2010,Mo Williams,PG,27,CLE,11,11,411,52,127,0.409,17,52,0.327,35,75,0.467,0.476,37,46,0.804,3,31,34,59,6,2,23,35,158
2010,Shelden Williams,PF,26,BOS,8,0,57,4,9,0.444,0,0,0,4,9,0.444,0.444,5,6,0.833,2,11,13,0,1,0,6,8,13
2010,Metta World Peace,SF,30,LAL,23,23,839,101,254,0.398,34,117,0.291,67,137,0.489,0.465,22,38,0.579,33,58,91,49,35,12,25,67,258
2010,Dorell Wright,SF,24,MIA,5,0,112,9,25,0.36,2,8,0.25,7,17,0.412,0.4,5,5,1,2,17,19,9,2,0,6,3,25
2011,Arron Afflalo,SG,25,DEN,3,3,85,12,34,0.353,3,12,0.25,9,22,0.409,0.397,7,8,0.875,0,9,9,7,0,0,3,10,34
2011,LaMarcus Aldridge,PF,25,POR,6,6,258,53,115,0.461,0,0,0,53,115,0.461,0.461,19,24,0.792,16,29,45,8,8,10,9,19,125
2011,Malik Allen,PF,32,ORL,1,0,7,0,1,0,0,0,0,0,1,0,0,1,2,0.5,0,1,1,0,0,0,0,2,1
2011,Ray Allen*,SG,35,BOS,9,9,361,57,109,0.523,32,56,0.571,25,53,0.472,0.67,24,25,0.96,5,29,34,22,11,1,10,21,170
2011,Tony Allen,SG,29,MEM,13,13,350,43,101,0.426,1,7,0.143,42,94,0.447,0.431,27,41,0.659,15,23,38,20,25,5,24,43,114
2011,Chris Andersen,C,32,DEN,5,0,73,7,11,0.636,0,0,0,7,11,0.636,0.636,10,14,0.714,5,9,14,3,3,7,3,8,24
2011,Ryan Anderson,PF,22,ORL,6,0,147,8,30,0.267,6,20,0.3,2,10,0.2,0.367,6,6,1,10,17,27,3,5,1,1,16,28
2011,Carmelo Anthony,SF,26,NYK,4,4,156,33,88,0.375,9,26,0.346,24,62,0.387,0.426,29,34,0.853,13,28,41,19,5,3,13,16,104
2011,Joel Anthony,C,28,MIA,21,13,575,18,49,0.367,0,0,0,18,49,0.367,0.367,22,31,0.71,35,62,97,10,8,38,13,54,58
2011,Gilbert Arenas,PG,29,ORL,5,0,81,18,42,0.429,3,12,0.25,15,30,0.5,0.464,4,6,0.667,4,10,14,12,1,1,6,14,43
2011,Trevor Ariza,SF,25,NOH,6,6,241,35,85,0.412,7,21,0.333,28,64,0.438,0.453,16,22,0.727,7,32,39,20,8,3,7,16,93
2011,Hilton Armstrong,C,26,ATL,8,0,35,1,5,0.2,0,0,0,1,5,0.2,0.2,3,6,0.5,4,6,10,1,3,0,2,7,5
2011,Darrell Arthur,PF,22,MEM,13,0,201,39,85,0.459,1,1,1,38,84,0.452,0.465,13,17,0.765,14,15,29,7,7,12,12,30,92
2011,Omer Asik,C,24,CHI,15,0,148,6,13,0.462,0,0,0,6,13,0.462,0.462,3,10,0.3,10,21,31,1,2,8,7,21,15
2011,J.J. Barea,PG,26,DAL,21,3,390,72,172,0.419,16,50,0.32,56,122,0.459,0.465,27,34,0.794,8,31,39,71,6,0,23,28,187
2011,Matt Barnes,SF,30,LAL,10,0,131,15,38,0.395,2,12,0.167,13,26,0.5,0.421,4,7,0.571,11,17,28,5,7,2,6,23,36
2011,Earl Barron,C,29,POR,1,0,0,0,0,,0,0,0,0,0,0,,0,0,0,0,0,0,0,0,0,0,0,0
2011,Brandon Bass,PF,25,ORL,6,6,139,16,38,0.421,0,0,0,16,38,0.421,0.421,12,13,0.923,12,13,25,2,3,5,7,7,44
2011,Tony Battie,C,34,PHI,5,0,38,3,7,0.429,0,0,0,3,7,0.429,0.429,1,2,0.5,2,8,10,0,0,3,1,5,7
2011,Shane Battier,SF,32,MEM,13,0,339,29,66,0.439,8,29,0.276,21,37,0.568,0.5,6,9,0.667,17,35,52,15,7,6,6,27,72
2011,Nicolas Batum,SF,22,POR,6,0,151,19,46,0.413,7,26,0.269,12,20,0.6,0.489,3,4,0.75,1,9,10,8,5,5,7,14,48
2011,Marco Belinelli,SG,24,NOH,6,6,173,23,63,0.365,8,26,0.308,15,37,0.405,0.429,4,4,1,0,5,5,4,5,0,4,12,58
2011,Mike Bibby,PG,32,MIA,20,20,415,27,96,0.281,17,66,0.258,10,30,0.333,0.37,2,4,0.5,5,31,36,23,11,6,17,30,73
2011,Chauncey Billups,PG,34,NYK,1,1,35,3,11,0.273,2,6,0.333,1,5,0.2,0.364,2,2,1,0,2,2,4,0,0,3,2,10
2011,DeJuan Blair,PF,21,SAS,4,0,50,7,21,0.333,0,0,0,7,21,0.333,0.333,3,5,0.6,9,4,13,2,0,1,2,6,17
2011,Steve Blake,PG,30,LAL,9,0,145,7,23,0.304,6,18,0.333,1,5,0.2,0.435,0,0,0,1,13,14,20,5,0,5,8,20
2011,Keith Bogans,SG,30,CHI,16,16,307,28,69,0.406,25,59,0.424,3,10,0.3,0.587,1,4,0.25,4,16,20,12,10,3,7,26,82
2011,Matt Bonner,PF,30,SAS,6,0,123,12,25,0.48,6,18,0.333,6,7,0.857,0.6,8,10,0.8,7,12,19,2,1,1,1,18,38
2011,Carlos Boozer,C,29,CHI,16,16,507,77,178,0.433,0,1,0,77,177,0.435,0.433,48,60,0.8,40,115,155,28,9,7,28,49,202
2011,Chris Bosh,PF,26,MIA,21,21,834,138,291,0.474,0,4,0,138,287,0.481,0.474,114,140,0.814,47,131,178,23,14,19,40,48,390
2011,Elton Brand,PF,31,PHI,5,5,185,34,62,0.548,0,0,0,34,62,0.548,0.548,10,13,0.769,12,30,42,3,2,6,4,21,78
2011,Corey Brewer,SG,24,DAL,6,0,23,4,9,0.444,1,3,0.333,3,6,0.5,0.5,0,0,0,0,2,2,1,4,0,2,5,9
2011,Ronnie Brewer,SG,25,CHI,16,0,260,24,50,0.48,3,7,0.429,21,43,0.488,0.51,13,17,0.765,7,27,34,15,12,6,4,14,64
2011,Shannon Brown,SG,25,LAL,10,0,166,28,61,0.459,7,25,0.28,21,36,0.583,0.516,9,14,0.643,5,14,19,7,6,2,9,10,72
2011,Kobe Bryant,SG,32,LAL,10,10,354,83,186,0.446,12,41,0.293,71,145,0.49,0.478,50,61,0.82,8,26,34,33,16,3,31,23,228
2011,Rasual Butler,SG,31,CHI,3,0,7,1,1,1,1,1,1,0,0,0,1.5,0,0,0,0,1,1,0,0,0,0,0,3
2011,Andrew Bynum,C,23,LAL,10,10,320,57,105,0.543,0,0,0,57,105,0.543,0.543,30,36,0.833,36,60,96,8,5,14,20,33,144
2011,Marcus Camby,C,36,POR,6,6,167,10,22,0.455,1,1,1,9,21,0.429,0.477,0,2,0,18,40,58,8,4,9,5,18,21
2011,Brian Cardinal,SF,33,DAL,9,0,37,3,4,0.75,3,4,0.75,0,0,0,1.125,1,2,0.5,0,3,3,2,1,0,3,8,10
2011,Anthony Carter,PG,35,NYK,4,0,49,8,15,0.533,1,3,0.333,7,12,0.583,0.567,2,2,1,2,6,8,6,2,1,4,1,19
2011,Mario Chalmers,PG,24,MIA,21,1,511,54,124,0.435,32,84,0.381,22,40,0.55,0.565,23,32,0.719,4,36,40,44,27,1,28,48,163
2011,Tyson Chandler,C,28,DAL,21,21,680,57,98,0.582,0,0,0,57,98,0.582,0.582,53,78,0.679,79,114,193,8,13,19,14,77,167
2011,Wilson Chandler,SF,23,DEN,5,2,115,8,29,0.276,1,7,0.143,7,22,0.318,0.293,7,9,0.778,2,20,22,2,3,4,4,15,24
2011,Earl Clark,SF,23,ORL,1,0,6,1,3,0.333,0,0,0,1,3,0.333,0.333,0,0,0,2,2,4,1,1,1,0,0,2
2011,Jason Collins,C,32,ATL,12,9,158,9,14,0.643,0,0,0,9,14,0.643,0.643,3,8,0.375,6,11,17,1,5,3,5,31,21
2011,Darren Collison,PG,23,IND,5,5,146,18,46,0.391,4,6,0.667,14,40,0.35,0.435,7,11,0.636,4,9,13,20,5,2,9,7,47
2011,Nick Collison,C,30,OKC,17,0,413,48,76,0.632,0,0,0,48,76,0.632,0.632,18,23,0.783,47,51,98,15,15,15,13,63,114
2011,Mike Conley,PG,23,MEM,13,13,507,71,183,0.388,11,37,0.297,60,146,0.411,0.418,44,53,0.83,7,43,50,83,14,3,30,39,197
2011,Daequan Cook,SG,23,OKC,17,0,195,22,56,0.393,16,46,0.348,6,10,0.6,0.536,4,4,1,1,26,27,1,3,0,7,17,64
2011,Jamal Crawford,SG,30,ATL,12,0,358,61,155,0.394,21,60,0.35,40,95,0.421,0.461,42,51,0.824,1,15,16,30,9,4,16,17,185
2011,Glen Davis,C,25,BOS,9,0,191,18,46,0.391,0,1,0,18,45,0.4,0.391,8,11,0.727,7,25,32,8,3,0,9,21,44
2011,Luol Deng,SF,25,CHI,16,16,687,98,230,0.426,22,68,0.324,76,162,0.469,0.474,52,62,0.839,27,79,106,43,24,10,26,40,270
2011,Toney Douglas,SG,24,NYK,4,3,112,15,41,0.366,7,18,0.389,8,23,0.348,0.451,6,6,1,2,11,13,9,2,0,4,12,43
2011,Chris Duhon,PG,28,ORL,1,0,4,1,2,0.5,1,2,0.5,0,0,0,0.75,2,2,1,0,0,0,0,0,0,0,0,5
2011,Tim Duncan,C,34,SAS,6,6,212,33,69,0.478,0,0,0,33,69,0.478,0.478,10,16,0.625,16,47,63,16,3,15,18,17,76
2011,Mike Dunleavy,SG,30,IND,5,0,72,7,20,0.35,3,10,0.3,4,10,0.4,0.425,8,12,0.667,0,6,6,8,4,0,1,3,25
2011,Kevin Durant,SF,22,OKC,17,17,722,155,345,0.449,37,109,0.339,118,236,0.5,0.503,140,167,0.838,18,121,139,48,16,19,42,52,487
2011,Patrick Ewing,SF,26,NOH,2,0,2,1,1,1,1,1,1,0,0,0,1.5,0,0,0,0,0,0,0,0,0,0,0,3
2011,Raymond Felton,SG,26,DEN,5,0,152,18,50,0.36,4,16,0.25,14,34,0.412,0.4,18,24,0.75,0,9,9,21,6,0,10,10,58
2011,Rudy Fernandez,SG,25,POR,6,0,81,4,18,0.222,3,10,0.3,1,8,0.125,0.306,6,9,0.667,2,10,12,5,2,1,2,7,17
2011,Landry Fields,SG,22,NYK,4,4,71,3,15,0.2,0,4,0,3,11,0.273,0.2,1,6,0.167,1,4,5,5,2,3,4,0,7
2011,Derek Fisher,PG,36,LAL,10,10,325,29,67,0.433,7,17,0.412,22,50,0.44,0.485,17,21,0.81,1,26,27,36,14,2,8,25,82
2011,Gary Forbes,SF,25,DEN,1,0,2,0,1,0,0,0,0,0,1,0,0,0,0,0,0,1,1,0,0,0,0,0,0
2011,T.J. Ford,PG,27,IND,2,0,14,3,3,1,1,1,1,2,2,1,1.167,0,0,0,0,1,1,2,0,0,2,0,7
2011,Jeff Foster,C,34,IND,5,0,93,7,12,0.583,0,0,0,7,12,0.583,0.583,3,8,0.375,10,14,24,4,2,4,5,14,17
2011,Danilo Gallinari,SF,22,DEN,5,5,148,19,44,0.432,7,15,0.467,12,29,0.414,0.511,15,21,0.714,1,16,17,10,4,0,7,17,60
2011,Kevin Garnett,PF,34,BOS,9,9,328,56,127,0.441,0,1,0,56,126,0.444,0.441,22,29,0.759,21,77,98,23,17,9,19,27,134
2011,Marc Gasol,C,26,MEM,13,13,519,72,141,0.511,0,2,0,72,139,0.518,0.511,51,73,0.699,41,105,146,29,14,28,26,44,195
2011,Pau Gasol,C,30,LAL,10,10,358,47,112,0.42,1,2,0.5,46,110,0.418,0.424,36,45,0.8,32,46,78,38,4,17,17,33,131
2011,Paul George,SG,20,IND,5,5,133,10,33,0.303,3,13,0.231,7,20,0.35,0.348,7,8,0.875,5,20,25,5,7,10,7,11,30
2011,Taj Gibson,PF,25,CHI,16,0,284,43,76,0.566,0,1,0,43,75,0.573,0.566,9,15,0.6,26,40,66,9,5,22,14,32,95
2011,Manu Ginobili,SG,33,SAS,5,5,174,31,70,0.443,9,28,0.321,22,42,0.524,0.507,32,41,0.78,2,18,20,21,13,3,17,13,103
2011,Danny Granger,SF,27,IND,5,5,183,43,90,0.478,8,23,0.348,35,67,0.522,0.522,14,16,0.875,6,22,28,16,6,1,7,12,108
2011,Aaron Gray,C,26,NOH,6,0,87,9,13,0.692,0,0,0,9,13,0.692,0.692,3,8,0.375,3,18,21,2,2,2,5,13,21
2011,Danny Green,SG,23,SAS,4,0,7,2,6,0.333,1,4,0.25,1,2,0.5,0.417,0,0,0,0,1,1,2,1,1,1,1,5
2011,Jeff Green,SF,24,BOS,9,0,173,23,53,0.434,7,16,0.438,16,37,0.432,0.5,13,18,0.722,6,18,24,2,5,4,12,20,66
2011,Willie Green,SG,29,NOH,6,0,84,14,36,0.389,2,9,0.222,12,27,0.444,0.417,4,7,0.571,1,4,5,4,2,0,3,14,34
2011,Hamed Haddadi,C,25,MEM,9,0,31,3,10,0.3,0,1,0,3,9,0.333,0.3,5,6,0.833,3,5,8,0,0,5,2,7,11
2011,Tyler Hansbrough,PF,25,IND,5,5,164,20,60,0.333,0,0,0,20,60,0.333,0.333,16,18,0.889,13,14,27,5,6,0,9,13,56
2011,James Harden,SG,21,OKC,17,0,537,66,139,0.475,23,76,0.303,43,63,0.683,0.558,66,80,0.825,10,81,91,61,21,13,28,48,221
2011,Al Harrington,PF,30,DEN,5,0,70,10,22,0.455,5,10,0.5,5,12,0.417,0.568,3,4,0.75,1,6,7,5,3,0,4,7,28
2011,Udonis Haslem,PF,30,MIA,12,0,290,27,68,0.397,0,0,0,27,68,0.397,0.397,9,10,0.9,13,41,54,9,6,4,11,31,63
2011,Spencer Hawes,C,22,PHI,5,5,98,12,33,0.364,0,1,0,12,32,0.375,0.364,2,4,0.5,5,14,19,9,0,2,2,11,26
2011,Brendan Haywood,C,31,DAL,18,0,275,18,31,0.581,0,0,0,18,31,0.581,0.581,20,43,0.465,34,39,73,4,2,18,13,48,56
2011,Roy Hibbert,C,24,IND,5,5,132,20,45,0.444,0,0,0,20,45,0.444,0.444,12,17,0.706,15,19,34,3,2,9,13,21,52
2011,Nene Hilario,C,28,DEN,5,5,162,22,46,0.478,0,0,0,22,46,0.478,0.478,27,48,0.563,14,31,45,8,5,4,8,17,71
2011,George Hill,PG,24,SAS,6,1,189,20,50,0.4,4,15,0.267,16,35,0.457,0.44,26,30,0.867,5,25,30,14,9,2,8,15,70
2011,Kirk Hinrich,PG,30,ATL,6,6,173,26,52,0.5,8,19,0.421,18,33,0.545,0.577,1,1,1,1,13,14,16,7,2,4,21,61
2011,Jrue Holiday,PG,20,PHI,5,5,188,24,58,0.414,11,21,0.524,13,37,0.351,0.509,12,15,0.8,3,16,19,28,10,2,11,10,71
2011,Al Horford,C,24,ATL,12,12,468,58,137,0.423,0,2,0,58,135,0.43,0.423,20,26,0.769,25,90,115,42,5,12,17,33,136
2011,Eddie House,SG,32,MIA,7,0,48,4,17,0.235,3,10,0.3,1,7,0.143,0.324,0,0,0,1,4,5,1,4,0,4,6,11
2011,Dwight Howard,C,25,ORL,6,6,258,51,81,0.63,0,1,0,51,80,0.638,0.63,60,88,0.682,27,66,93,3,4,11,33,25,162
2011,Juwan Howard,PF,37,MIA,11,0,60,4,9,0.444,0,0,0,4,9,0.444,0.444,9,13,0.692,3,7,10,1,0,0,2,8,17
2011,Serge Ibaka,PF,21,OKC,17,17,490,67,145,0.462,0,1,0,67,144,0.465,0.462,33,40,0.825,47,77,124,3,4,52,21,64,167
2011,Andre Iguodala,SF,27,PHI,5,5,182,22,52,0.423,3,14,0.214,19,38,0.5,0.452,10,14,0.714,7,28,35,34,5,2,14,16,57
2011,Zydrunas Ilgauskas,C,35,MIA,9,8,104,14,30,0.467,0,0,0,14,30,0.467,0.467,4,6,0.667,15,17,32,3,0,3,9,16,32
2011,Didier Ilunga-Mbenga,C,30,NOH,5,0,26,2,2,1,0,0,0,2,2,1,1,1,2,0.5,2,3,5,1,2,3,1,7,5
2011,Royal Ivey,SG,29,OKC,2,0,6,2,2,1,2,2,1,0,0,0,1.5,0,0,0,0,1,1,1,0,0,0,0,6
2011,Jarrett Jack,SG,27,NOH,6,0,111,12,34,0.353,0,5,0,12,29,0.414,0.353,11,16,0.688,1,14,15,13,1,1,8,4,35
2011,LeBron James,SF,26,MIA,21,21,922,174,373,0.466,30,85,0.353,144,288,0.5,0.507,119,156,0.763,34,142,176,123,35,25,66,56,497
2011,Richard Jefferson,SF,30,SAS,6,6,176,12,31,0.387,6,17,0.353,6,14,0.429,0.484,9,11,0.818,2,23,25,5,3,3,6,13,39
2011,Jared Jeffries,PF,29,NYK,4,0,85,11,23,0.478,0,0,0,11,23,0.478,0.478,3,4,0.75,13,7,20,1,3,7,3,7,25
2011,Armon Johnson,PG,21,POR,2,0,0,0,0,,0,0,0,0,0,0,,0,0,0,0,1,1,0,0,0,0,0,0
2011,Chris Johnson,C,25,POR,4,0,19,1,1,1,0,0,0,1,1,1,1,2,2,1,0,5,5,0,0,2,0,3,4
2011,Joe Johnson,SG,29,ATL,12,12,497,87,198,0.439,18,42,0.429,69,156,0.442,0.485,34,42,0.81,18,37,55,40,13,1,31,19,226
2011,Trey Johnson,SG,26,LAL,3,0,12,1,5,0.2,0,1,0,1,4,0.25,0.2,1,2,0.5,1,3,4,1,0,0,0,2,3
2011,Dahntay Jones,SG,30,IND,3,0,50,9,20,0.45,0,3,0,9,17,0.529,0.45,8,9,0.889,2,0,2,2,1,0,3,7,26
2011,James Jones,SF,30,MIA,12,0,272,24,51,0.471,17,37,0.459,7,14,0.5,0.637,13,13,1,3,27,30,2,6,2,4,24,78
2011,Jason Kidd*,PG,37,DAL,21,21,744,64,161,0.398,43,115,0.374,21,46,0.457,0.531,24,30,0.8,11,84,95,153,40,10,56,36,195
2011,Kyle Korver,SG,29,CHI,16,0,276,38,98,0.388,22,52,0.423,16,46,0.348,0.5,7,7,1,1,18,19,17,8,3,16,35,105
2011,Kosta Koufos,C,21,DEN,1,0,2,1,1,1,0,0,0,1,1,1,1,0,0,0,0,0,0,0,0,0,0,0,2
2011,Nenad Krstic,C,27,BOS,7,0,56,5,8,0.625,0,0,0,5,8,0.625,0.625,2,3,0.667,5,7,12,2,0,4,3,8,12
2011,Carl Landry,PF,27,NOH,6,6,213,31,68,0.456,0,0,0,31,68,0.456,0.456,33,36,0.917,11,19,30,6,4,3,12,25,95
2011,Ty Lawson,PG,23,DEN,5,5,167,26,52,0.5,5,11,0.455,21,41,0.512,0.548,21,23,0.913,7,10,17,19,5,1,6,9,78
2011,Jamaal Magloire,C,32,MIA,3,0,18,2,5,0.4,0,0,0,2,5,0.4,0.4,0,0,0,1,4,5,2,1,0,1,4,4
2011,Ian Mahinmi,C,24,DAL,6,0,33,3,5,0.6,0,0,0,3,5,0.6,0.6,5,9,0.556,3,3,6,0,1,0,0,16,11
2011,Shawn Marion,SF,32,DAL,21,21,690,105,225,0.467,0,5,0,105,220,0.477,0.467,40,47,0.851,46,87,133,45,21,19,36,53,250
2011,Kenyon Martin,PF,33,DEN,5,5,148,24,50,0.48,0,0,0,24,50,0.48,0.48,11,18,0.611,6,33,39,8,2,2,7,18,59
2011,Roger Mason,SG,30,NYK,3,0,55,7,18,0.389,5,13,0.385,2,5,0.4,0.528,0,0,0,3,1,4,3,1,0,1,6,19
2011,Wesley Matthews,SG,24,POR,6,6,202,27,57,0.474,8,21,0.381,19,36,0.528,0.544,16,19,0.842,2,5,7,6,4,1,7,15,78
2011,Eric Maynor,PG,23,OKC,17,0,220,29,77,0.377,9,25,0.36,20,52,0.385,0.435,15,19,0.789,5,17,22,37,9,0,16,16,82
2011,O.J. Mayo,SG,23,MEM,13,2,362,52,134,0.388,20,49,0.408,32,85,0.376,0.463,23,29,0.793,10,31,41,31,11,4,17,42,147
2011,Antonio McDyess,PF,36,SAS,6,6,145,15,36,0.417,0,0,0,15,36,0.417,0.417,4,7,0.571,10,20,30,8,2,5,7,21,34
2011,Josh McRoberts,PF,23,IND,5,0,79,8,24,0.333,0,1,0,8,23,0.348,0.333,9,11,0.818,8,10,18,6,4,1,5,17,25
2011,Jodie Meeks,SG,23,PHI,5,5,125,13,31,0.419,8,18,0.444,5,13,0.385,0.548,5,6,0.833,2,8,10,4,3,0,2,6,39
2011,Andre Miller,PG,34,POR,6,6,194,33,67,0.493,4,10,0.4,29,57,0.509,0.522,19,24,0.792,5,14,19,33,2,0,13,17,89
2011,Mike Miller,SG,30,MIA,18,0,215,18,53,0.34,11,37,0.297,7,16,0.438,0.443,0,0,0,9,40,49,13,7,1,8,26,47
2011,Patty Mills,PG,22,POR,2,0,5,0,2,0,0,1,0,0,1,0,0,0,0,0,0,1,1,0,0,0,1,0,0
2011,Nazr Mohammed,C,33,OKC,14,0,148,14,34,0.412,0,0,0,14,34,0.412,0.412,4,10,0.4,9,23,32,0,4,6,6,27,32
2011,Troy Murphy,PF,30,BOS,1,0,3,0,0,,0,0,0,0,0,0,,0,0,0,1,0,1,0,0,0,0,0,0
2011,Gary Neal,SG,26,SAS,6,0,111,17,46,0.37,5,19,0.263,12,27,0.444,0.424,7,7,1,2,16,18,5,1,1,2,11,46
2011,Jameer Nelson,PG,28,ORL,6,6,216,31,82,0.378,6,26,0.231,25,56,0.446,0.415,11,14,0.786,7,18,25,30,12,0,8,14,79
2011,Joakim Noah,C,25,CHI,16,16,529,51,124,0.411,0,0,0,51,124,0.411,0.411,37,51,0.725,68,95,163,40,16,33,19,63,139
2011,Andres Nocioni,SF,31,PHI,1,0,10,0,3,0,0,2,0,0,1,0,0,0,0,0,0,2,2,0,0,0,1,1,0
2011,Steve Novak,SF,27,SAS,1,0,6,0,0,,0,0,0,0,0,0,,0,0,0,0,1,1,0,0,0,0,0,0
2011,Dirk Nowitzki,PF,32,DAL,21,21,826,192,396,0.485,23,50,0.46,169,346,0.488,0.514,175,186,0.941,12,159,171,53,12,13,65,46,582
2011,Jermaine O'Neal,C,32,BOS,9,9,197,21,43,0.488,0,0,0,21,43,0.488,0.488,10,11,0.909,15,23,38,8,2,16,8,34,52
2011,Shaquille O'Neal*,C,38,BOS,2,0,12,1,2,0.5,0,0,0,1,2,0.5,0.5,0,2,0,0,0,0,1,1,0,0,4,2
2011,Lamar Odom,PF,31,LAL,10,1,286,45,98,0.459,4,20,0.2,41,78,0.526,0.48,27,38,0.711,13,52,65,21,2,4,15,25,121
2011,Emeka Okafor,C,28,NOH,6,6,188,20,31,0.645,0,0,0,20,31,0.645,0.645,4,11,0.364,17,16,33,0,6,6,12,28,44
2011,Zaza Pachulia,C,26,ATL,11,0,195,11,23,0.478,0,0,0,11,23,0.478,0.478,17,22,0.773,17,37,54,13,2,1,9,37,39
2011,Tony Parker,PG,28,SAS,6,6,221,43,93,0.462,1,8,0.125,42,85,0.494,0.468,31,41,0.756,1,15,16,31,8,2,20,10,118
2011,Chris Paul,PG,25,NOH,6,6,250,42,77,0.545,9,19,0.474,33,58,0.569,0.604,39,49,0.796,3,37,40,69,11,0,22,11,132
2011,Kendrick Perkins,C,26,OKC,17,17,479,29,64,0.453,0,0,0,29,64,0.453,0.453,19,33,0.576,37,66,103,13,4,13,27,57,77
2011,Paul Pierce,SF,33,BOS,9,9,343,68,148,0.459,21,47,0.447,47,101,0.465,0.53,30,34,0.882,5,40,45,25,12,4,24,30,187
2011,Quincy Pondexter,SF,22,NOH,3,0,9,1,6,0.167,0,3,0,1,3,0.333,0.167,0,0,0,0,1,1,1,0,0,0,1,2
2011,Leon Powe,C,27,MEM,4,0,14,2,8,0.25,0,0,0,2,8,0.25,0.25,3,4,0.75,2,2,4,0,0,0,0,0,7
2011,Josh Powell,PF,28,ATL,9,0,48,5,9,0.556,0,0,0,5,9,0.556,0.556,0,0,0,3,6,9,1,0,0,2,8,10
2011,A.J. Price,PG,24,IND,5,0,80,13,35,0.371,7,16,0.438,6,19,0.316,0.471,9,10,0.9,2,5,7,6,3,0,7,5,42
2011,Zach Randolph,PF,29,MEM,13,13,515,100,224,0.446,2,8,0.25,98,216,0.454,0.451,87,106,0.821,43,98,141,31,14,10,27,45,289
2011,Theo Ratliff,C,37,LAL,1,0,1,0,0,,0,0,0,0,0,0,,0,0,0,0,1,1,0,0,0,0,0,0
2011,J.J. Redick,SG,26,ORL,6,0,120,15,42,0.357,1,15,0.067,14,27,0.519,0.369,9,12,0.75,0,11,11,6,1,1,7,8,40
2011,Jason Richardson,SG,30,ORL,5,5,153,17,51,0.333,8,25,0.32,9,26,0.346,0.412,8,8,1,5,15,20,6,3,2,3,16,50
2011,Quentin Richardson,SF,30,ORL,6,1,98,8,15,0.533,5,10,0.5,3,5,0.6,0.7,2,2,1,3,12,15,2,1,1,2,9,23
2011,Nate Robinson,PG,26,OKC,3,0,12,2,7,0.286,2,6,0.333,0,1,0,0.429,2,2,1,0,0,0,1,0,0,0,1,8
2011,Rajon Rondo,PG,24,BOS,9,9,345,51,107,0.477,0,3,0,51,104,0.49,0.477,24,38,0.632,11,38,49,86,10,0,33,16,126
2011,Derrick Rose,PG,22,CHI,16,16,649,149,376,0.396,25,101,0.248,124,275,0.451,0.43,111,134,0.828,20,49,69,123,22,11,59,33,434
2011,Brandon Roy,SG,26,POR,6,0,138,22,44,0.5,4,14,0.286,18,30,0.6,0.545,8,13,0.615,2,11,13,17,1,0,4,13,56
2011,Brandon Rush,SG,25,IND,5,0,55,6,13,0.462,3,4,0.75,3,9,0.333,0.577,1,2,0.5,0,7,7,3,1,1,1,5,16
2011,Thabo Sefolosha,SG,26,OKC,17,17,344,31,67,0.463,4,26,0.154,27,41,0.659,0.493,13,13,1,12,41,53,12,16,5,15,24,79
2011,Ish Smith,PG,22,MEM,5,0,10,2,3,0.667,0,0,0,2,3,0.667,0.667,0,0,0,0,2,2,2,1,0,1,1,4
2011,J.R. Smith,SF,25,DEN,5,0,76,16,45,0.356,9,21,0.429,7,24,0.292,0.456,8,11,0.727,1,9,10,5,2,0,8,8,49
2011,Jason Smith,C,24,NOH,6,0,58,7,15,0.467,0,0,0,7,15,0.467,0.467,0,0,0,1,6,7,1,2,0,0,11,14
2011,Joe Smith,PF,35,LAL,5,0,11,0,2,0,0,0,0,0,2,0,0,0,0,0,1,0,1,0,0,0,0,1,0
2011,Josh Smith,PF,25,ATL,12,12,438,69,171,0.404,3,24,0.125,66,147,0.449,0.412,40,67,0.597,18,84,102,35,13,25,26,39,181
2011,Marreese Speights,C,23,PHI,2,0,21,2,12,0.167,0,0,0,2,12,0.167,0.167,0,0,0,1,5,6,1,0,1,0,4,4
2011,Tiago Splitter,C,26,SAS,3,0,50,10,16,0.625,0,0,0,10,16,0.625,0.625,0,3,0,7,7,14,1,3,1,2,4,20
2011,DeShawn Stevenson,SG,29,DAL,21,18,332,29,83,0.349,27,68,0.397,2,15,0.133,0.512,9,12,0.75,1,18,19,12,11,2,10,40,94
2011,Peja Stojakovic,SF,33,DAL,19,0,350,49,120,0.408,29,77,0.377,20,43,0.465,0.529,7,9,0.778,3,29,32,7,12,2,9,21,134
2011,Amar'e Stoudemire,C,28,NYK,4,4,134,21,55,0.382,0,0,0,21,55,0.382,0.382,16,24,0.667,11,20,31,7,1,3,12,10,58
2011,Pape Sy,SF,22,ATL,4,0,11,2,3,0.667,0,0,0,2,3,0.667,0.667,2,4,0.5,1,0,1,3,1,0,1,1,6
2011,Jeff Teague,PG,22,ATL,8,6,238,37,72,0.514,1,7,0.143,36,65,0.554,0.521,19,23,0.826,0,17,17,28,6,3,8,10,94
2011,Jason Terry,SG,33,DAL,21,0,684,128,268,0.478,42,95,0.442,86,173,0.497,0.556,70,83,0.843,6,34,40,67,26,3,32,44,368
2011,Etan Thomas,C,32,ATL,1,0,7,0,2,0,0,0,0,0,2,0,0,0,0,0,1,0,1,0,0,0,0,1,0
2011,Kurt Thomas,PF,38,CHI,7,0,74,10,18,0.556,0,2,0,10,16,0.625,0.556,0,0,0,9,10,19,3,1,3,3,12,20
2011,Ronny Turiaf,C,28,NYK,4,4,75,8,12,0.667,0,0,0,8,12,0.667,0.667,7,10,0.7,4,7,11,4,1,6,3,4,23
2011,Hedo Turkoglu,SF,31,ORL,6,6,209,20,68,0.294,7,30,0.233,13,38,0.342,0.346,8,14,0.571,1,18,19,22,8,1,7,18,55
2011,Evan Turner,SG,22,PHI,5,0,97,17,38,0.447,4,5,0.8,13,33,0.394,0.5,2,2,1,4,19,23,4,3,1,0,9,40
2011,Greivis Vasquez,SG,24,MEM,13,0,142,21,41,0.512,4,11,0.364,17,30,0.567,0.561,10,13,0.769,3,16,19,25,5,2,9,11,56
2011,Dwyane Wade,SG,29,MIA,21,21,828,181,373,0.485,14,52,0.269,167,321,0.52,0.504,139,179,0.777,43,107,150,92,34,28,64,53,515
2011,Von Wafer,SG,25,BOS,3,0,5,0,2,0,0,1,0,0,1,0,0,0,0,0,0,1,1,0,0,0,0,0,0
2011,Henry Walker,SG,23,NYK,4,0,89,9,30,0.3,3,11,0.273,6,19,0.316,0.35,2,3,0.667,5,8,13,4,5,0,7,9,23
2011,Gerald Wallace,PF,28,POR,6,6,226,30,67,0.448,3,17,0.176,27,50,0.54,0.47,28,32,0.875,9,46,55,17,8,3,15,19,91
2011,Luke Walton,SF,30,LAL,1,0,4,0,2,0,0,2,0,0,0,0,0,0,0,0,0,1,1,0,0,0,2,0,0
2011,C.J. Watson,PG,26,CHI,16,0,136,19,56,0.339,3,15,0.2,16,41,0.39,0.366,10,11,0.909,2,12,14,31,8,0,17,15,51
2011,Delonte West,PG,27,BOS,9,0,170,22,47,0.468,7,19,0.368,15,28,0.536,0.543,8,10,0.8,4,13,17,12,5,0,12,16,59
2011,Russell Westbrook,PG,22,OKC,17,17,638,135,343,0.394,14,48,0.292,121,295,0.41,0.414,121,142,0.852,36,55,91,108,24,6,78,56,405
2011,Damien Wilkins,SF,31,ATL,8,0,39,7,13,0.538,0,2,0,7,11,0.636,0.538,0,0,0,3,5,8,1,2,2,2,2,14
2011,Lou Williams,SG,24,PHI,5,0,130,17,52,0.327,6,20,0.3,11,32,0.344,0.385,14,19,0.737,0,8,8,15,5,0,4,6,54
2011,Marvin Williams,SF,24,ATL,12,3,216,22,56,0.393,3,11,0.273,19,45,0.422,0.42,10,13,0.769,10,17,27,6,9,7,12,18,57
2011,Shawne Williams,PF,24,NYK,4,0,101,10,24,0.417,6,14,0.429,4,10,0.4,0.542,6,8,0.75,4,10,14,5,4,4,4,8,32
2011,Metta World Peace,SF,31,LAL,9,9,287,35,79,0.443,9,28,0.321,26,51,0.51,0.5,16,21,0.762,17,24,41,20,10,7,9,23,95
2011,Sam Young,SF,25,MEM,13,11,256,43,96,0.448,3,12,0.25,40,84,0.476,0.464,9,15,0.6,7,23,30,2,6,3,8,18,98
2011,Thaddeus Young,PF,22,PHI,5,0,127,25,60,0.417,0,1,0,25,59,0.424,0.417,7,12,0.583,17,12,29,4,4,1,7,13,57
2012,Arron Afflalo,SG,26,DEN,7,7,229,30,74,0.405,4,20,0.2,26,54,0.481,0.432,12,15,0.8,5,20,25,19,5,2,9,14,76
2012,Blake Ahearn,PG,27,UTA,3,0,8,2,3,0.667,1,1,1,1,2,0.5,0.833,0,0,0,0,0,0,2,0,0,0,0,5
2012,Cole Aldrich,C,23,OKC,5,0,25,4,9,0.444,0,0,0,4,9,0.444,0.444,2,4,0.5,5,8,13,0,0,0,0,3,10
2012,Lavoy Allen,PF,22,PHI,12,1,236,34,61,0.557,0,0,0,34,61,0.557,0.557,7,12,0.583,21,38,59,3,10,11,5,30,75
2012,Ray Allen*,SG,36,BOS,18,10,616,66,167,0.395,28,92,0.304,38,75,0.507,0.479,32,45,0.711,8,66,74,18,17,2,17,41,192
2012,Tony Allen,SG,30,MEM,7,7,170,18,45,0.4,0,5,0,18,40,0.45,0.4,12,17,0.706,8,14,22,5,9,7,10,21,48
2012,Lou Amundson,PF,29,IND,11,0,94,12,23,0.522,0,0,0,12,23,0.522,0.522,3,6,0.5,6,17,23,2,2,5,4,16,27
2012,James Anderson,SG,22,SAS,8,0,31,4,9,0.444,2,4,0.5,2,5,0.4,0.556,1,2,0.5,0,5,5,3,1,0,0,1,11
2012,Ryan Anderson,PF,23,ORL,5,5,172,15,44,0.341,12,30,0.4,3,14,0.214,0.477,6,7,0.857,9,14,23,4,3,2,9,22,48
2012,Carmelo Anthony,SF,27,NYK,5,5,204,52,124,0.419,4,18,0.222,48,106,0.453,0.435,31,41,0.756,13,28,41,11,6,1,14,21,139
2012,Joel Anthony,C,29,MIA,17,1,329,17,29,0.586,0,0,0,17,29,0.586,0.586,20,25,0.8,22,33,55,2,5,16,8,41,54
2012,Gilbert Arenas,PG,30,MEM,6,0,23,2,8,0.25,0,4,0,2,4,0.5,0.25,0,0,0,0,1,1,1,0,0,1,6,4
2012,Omer Asik,C,25,CHI,6,3,128,7,14,0.5,0,0,0,7,14,0.5,0.5,6,17,0.353,8,20,28,8,1,10,8,14,20
2012,Jeff Ayres,C,24,IND,4,0,9,1,3,0.333,0,0,0,1,3,0.333,0.333,0,0,0,0,2,2,0,0,0,0,2,2
2012,Kelenna Azubuike,SG,28,DAL,1,0,5,1,3,0.333,1,1,1,0,2,0,0.5,0,0,0,1,0,1,0,1,0,1,0,3
2012,Leandro Barbosa,SG,29,IND,11,0,223,27,73,0.37,3,20,0.15,24,53,0.453,0.39,6,12,0.5,5,19,24,14,5,1,13,23,63
2012,Matt Barnes,SF,31,LAL,11,0,185,16,59,0.271,5,31,0.161,11,28,0.393,0.314,2,4,0.5,9,27,36,16,10,5,15,29,39
2012,Brandon Bass,PF,26,BOS,20,20,608,81,175,0.463,0,0,0,81,175,0.463,0.463,59,64,0.922,26,79,105,15,14,10,15,50,221
2012,Shane Battier,SF,33,MIA,23,16,768,53,140,0.379,42,110,0.382,11,30,0.367,0.529,13,16,0.813,15,59,74,27,22,14,16,69,161
2012,Rodrigue Beaubois,PG,23,DAL,2,0,12,0,2,0,0,1,0,0,1,0,0,0,0,0,0,1,1,2,0,0,1,1,0
2012,Mike Bibby,PG,33,NYK,5,1,118,9,23,0.391,7,17,0.412,2,6,0.333,0.543,2,3,0.667,3,18,21,13,1,0,4,7,27
2012,DeJuan Blair,PF,22,SAS,10,0,76,17,27,0.63,0,0,0,17,27,0.63,0.63,3,6,0.5,7,16,23,2,3,1,1,10,37
2012,Steve Blake,PG,31,LAL,12,0,306,26,62,0.419,18,43,0.419,8,19,0.421,0.565,5,7,0.714,8,26,34,27,8,2,15,21,75
2012,Eric Bledsoe,PG,22,LAC,11,0,189,37,63,0.587,3,7,0.429,34,56,0.607,0.611,10,16,0.625,12,14,26,23,13,4,15,23,87
2012,Matt Bonner,PF,31,SAS,13,0,165,10,32,0.313,8,23,0.348,2,9,0.222,0.438,3,5,0.6,2,23,25,9,2,4,3,24,31
2012,Carlos Boozer,PF,30,CHI,6,6,200,38,90,0.422,0,0,0,38,90,0.422,0.422,5,7,0.714,10,49,59,18,5,2,23,20,81
2012,Chris Bosh,PF,27,MIA,14,10,439,73,148,0.493,7,13,0.538,66,135,0.489,0.517,43,52,0.827,36,73,109,8,6,14,20,20,196
2012,Avery Bradley,PG,21,BOS,10,10,248,25,68,0.368,5,22,0.227,20,46,0.435,0.404,12,18,0.667,3,17,20,8,8,6,10,20,67
2012,Elton Brand,C,32,PHI,13,13,356,46,99,0.465,0,0,0,46,99,0.465,0.465,20,32,0.625,22,41,63,7,11,20,7,36,112
2012,Corey Brewer,SF,25,DEN,7,0,116,23,54,0.426,6,20,0.3,17,34,0.5,0.481,6,8,0.75,6,8,14,6,7,2,2,11,58
2012,Ronnie Brewer,SG,26,CHI,5,0,83,4,16,0.25,0,0,0,4,16,0.25,0.25,0,3,0,4,15,19,9,4,1,6,5,8
2012,Kobe Bryant,SG,33,LAL,12,12,476,132,301,0.439,17,60,0.283,115,241,0.477,0.467,79,95,0.832,16,42,58,52,16,2,34,33,360
2012,Alec Burks,SG,20,UTA,4,0,63,7,28,0.25,0,2,0,7,26,0.269,0.25,12,14,0.857,5,6,11,3,2,0,3,4,26
2012,Caron Butler,SF,31,LAC,10,10,268,33,92,0.359,8,31,0.258,25,61,0.41,0.402,12,16,0.75,4,26,30,10,6,2,16,22,86
2012,Jimmy Butler,SG,22,CHI,3,0,4,0,0,,0,0,0,0,0,0,,0,0,0,0,0,0,0,0,0,0,1,0
2012,Andrew Bynum,C,24,LAL,12,12,451,73,153,0.477,0,0,0,73,153,0.477,0.477,54,69,0.783,46,87,133,18,5,37,16,21,200
2012,Brian Cardinal,SF,34,DAL,2,0,9,1,2,0.5,1,1,1,0,1,0,0.75,0,0,0,0,3,3,0,0,0,0,0,3
2012,DeMarre Carroll,SF,25,UTA,4,0,73,9,19,0.474,1,5,0.2,8,14,0.571,0.5,0,0,0,7,8,15,3,2,1,3,9,19
2012,Vince Carter,SG,35,DAL,4,0,107,12,41,0.293,3,10,0.3,9,31,0.29,0.329,6,8,0.75,5,17,22,1,5,2,6,11,33
2012,Mario Chalmers,PG,25,MIA,23,23,819,92,208,0.442,33,92,0.359,59,116,0.509,0.522,43,60,0.717,12,72,84,90,28,6,42,69,260
2012,Tyson Chandler,C,29,NYK,5,5,167,11,25,0.44,0,0,0,11,25,0.44,0.44,9,15,0.6,18,27,45,4,7,7,15,18,31
2012,Earl Clark,PF,24,ORL,5,0,88,8,18,0.444,0,0,0,8,18,0.444,0.444,4,7,0.571,8,25,33,1,2,5,4,6,20
2012,Norris Cole,PG,23,MIA,19,0,170,12,37,0.324,3,12,0.25,9,25,0.36,0.365,7,9,0.778,1,9,10,12,7,0,5,24,34
2012,Jason Collins,C,33,ATL,5,4,85,6,11,0.545,0,0,0,6,11,0.545,0.545,0,0,0,4,8,12,0,1,0,10,16,12
2012,Darren Collison,PG,24,IND,11,0,205,36,70,0.514,4,11,0.364,32,59,0.542,0.543,20,23,0.87,3,11,14,33,14,0,11,11,96
2012,Nick Collison,PF,31,OKC,20,0,332,33,51,0.647,0,0,0,33,51,0.647,0.647,3,7,0.429,30,37,67,19,12,5,12,51,69
2012,Mike Conley,PG,24,MEM,7,7,277,32,76,0.421,11,22,0.5,21,54,0.389,0.493,24,32,0.75,4,19,23,50,6,0,16,19,99
2012,Daequan Cook,SG,24,OKC,16,0,109,14,37,0.378,8,24,0.333,6,13,0.462,0.486,0,2,0,0,9,9,4,3,0,0,7,36
2012,Dante Cunningham,PF,24,MEM,7,0,49,4,11,0.364,0,0,0,4,11,0.364,0.364,0,0,0,6,5,11,0,1,2,1,3,8
2012,Erick Dampier,C,36,ATL,4,0,55,7,13,0.538,0,0,0,7,13,0.538,0.538,2,3,0.667,7,7,14,0,0,1,3,6,16
2012,Marquis Daniels,SG,31,BOS,15,0,92,11,19,0.579,0,2,0,11,17,0.647,0.579,8,10,0.8,1,9,10,3,2,1,2,13,30
2012,Baron Davis,PG,32,NYK,4,4,97,11,23,0.478,4,14,0.286,7,9,0.778,0.565,5,5,1,0,3,3,13,0,0,13,15,31
2012,Glen Davis,PF,26,ORL,5,5,190,39,89,0.438,0,0,0,39,89,0.438,0.438,17,22,0.773,23,23,46,4,3,6,9,10,95
2012,Luol Deng,SF,26,CHI,6,6,228,36,79,0.456,8,22,0.364,28,57,0.491,0.506,4,7,0.571,8,42,50,9,5,9,10,10,84
2012,Boris Diaw,PF,29,SAS,14,14,346,36,70,0.514,9,18,0.5,27,52,0.519,0.579,6,8,0.75,28,45,73,35,11,4,15,29,87
2012,Keyon Dooling,SG,31,BOS,20,0,212,21,48,0.438,11,28,0.393,10,20,0.5,0.552,2,3,0.667,2,13,15,14,6,4,3,30,55
2012,Toney Douglas,PG,25,NYK,1,0,8,1,1,1,0,0,0,1,1,1,1,0,0,0,0,0,0,1,0,0,0,0,2
2012,Chris Duhon,PG,29,ORL,5,0,61,1,5,0.2,1,3,0.333,0,2,0,0.3,0,2,0,0,7,7,9,5,1,7,5,3
2012,Tim Duncan,C,35,SAS,14,14,463,101,204,0.495,0,1,0,101,203,0.498,0.495,41,58,0.707,32,99,131,39,10,29,21,30,243
2012,Kevin Durant,SF,23,OKC,20,20,837,198,383,0.517,41,110,0.373,157,273,0.575,0.57,133,154,0.864,13,135,148,74,29,24,63,51,570
2012,Devin Ebanks,SG,22,LAL,9,6,126,16,39,0.41,0,3,0,16,36,0.444,0.41,5,8,0.625,7,13,20,6,3,7,2,13,37
2012,Jeremy Evans,SF,24,UTA,2,0,7,0,1,0,0,0,0,0,1,0,0,2,2,1,0,3,3,1,1,0,0,1,2
2012,Reggie Evans,PF,31,LAC,11,0,198,8,15,0.533,0,0,0,8,15,0.533,0.533,17,40,0.425,20,60,80,1,9,6,9,31,33
2012,Christian Eyenga,SF,22,LAL,3,0,9,2,3,0.667,0,0,0,2,3,0.667,0.667,0,1,0,1,1,2,1,1,1,1,3,4
2012,Kenneth Faried,PF,22,DEN,7,7,192,32,60,0.533,0,0,0,32,60,0.533,0.533,9,12,0.75,25,45,70,4,5,8,14,20,73
2012,Derrick Favors,PF,20,UTA,4,1,116,15,36,0.417,0,0,0,15,36,0.417,0.417,17,29,0.586,14,24,38,2,5,6,5,11,47
2012,Landry Fields,SG,23,NYK,5,4,115,15,31,0.484,1,5,0.2,14,26,0.538,0.5,5,7,0.714,4,11,15,7,3,0,9,5,36
2012,Derek Fisher,PG,37,OKC,20,0,446,49,118,0.415,18,48,0.375,31,70,0.443,0.492,9,9,1,2,30,32,25,17,2,6,37,125
2012,Randy Foye,SG,28,LAC,11,11,291,29,74,0.392,14,32,0.438,15,42,0.357,0.486,11,13,0.846,4,18,22,17,6,3,12,19,83
2012,Danilo Gallinari,SF,23,DEN,7,7,222,34,94,0.362,4,23,0.174,30,71,0.423,0.383,22,24,0.917,9,27,36,17,5,4,9,15,94
2012,Kevin Garnett,C,35,BOS,20,20,737,159,320,0.497,1,4,0.25,158,316,0.5,0.498,65,80,0.813,31,175,206,30,23,29,44,59,384
2012,Marc Gasol,C,27,MEM,7,7,261,36,69,0.522,0,1,0,36,68,0.529,0.522,34,43,0.791,16,31,47,22,2,13,13,25,106
2012,Pau Gasol,PF,31,LAL,12,12,444,62,143,0.434,2,5,0.4,60,138,0.435,0.441,24,29,0.828,38,76,114,44,6,25,20,36,150
2012,Rudy Gay,SF,25,MEM,7,7,279,48,114,0.421,4,19,0.211,44,95,0.463,0.439,33,40,0.825,10,36,46,10,9,2,21,15,133
2012,Paul George,SG,21,IND,11,11,371,37,95,0.389,11,41,0.268,26,54,0.481,0.447,22,28,0.786,15,58,73,26,18,4,21,32,107
2012,Taj Gibson,PF,26,CHI,6,0,137,21,46,0.457,0,0,0,21,46,0.457,0.457,15,22,0.682,15,24,39,4,4,10,3,19,57
2012,Manu Ginobili,SG,34,SAS,14,2,390,65,145,0.448,23,68,0.338,42,77,0.545,0.528,48,56,0.857,8,41,49,56,10,4,42,36,201
2012,Andrew Goudelock,SG,23,LAL,4,0,10,2,3,0.667,1,1,1,1,2,0.5,0.833,0,0,0,0,1,1,0,0,0,0,1,5
2012,Danny Granger,SF,28,IND,11,11,420,69,174,0.397,26,73,0.356,43,101,0.426,0.471,23,28,0.821,15,47,62,27,6,4,29,31,187
2012,Danny Green,SG,24,SAS,14,12,289,38,91,0.418,20,58,0.345,18,33,0.545,0.527,7,10,0.7,3,42,45,15,7,10,15,24,103
2012,Willie Green,SG,30,ATL,5,0,63,6,13,0.462,1,4,0.25,5,9,0.556,0.5,0,0,0,1,7,8,3,0,0,2,6,13
2012,Blake Griffin,PF,22,LAC,11,11,393,84,168,0.5,0,1,0,84,167,0.503,0.5,42,66,0.636,19,57,76,27,20,10,25,41,210
2012,Hamed Haddadi,C,26,MEM,4,0,21,2,2,1,0,0,0,2,2,1,1,1,2,0.5,5,4,9,1,0,2,1,5,5
2012,Jordan Hamilton,SF,21,DEN,2,0,5,2,3,0.667,0,0,0,2,3,0.667,0.667,0,0,0,0,0,0,0,1,0,1,1,4
2012,Richard Hamilton,SG,33,CHI,6,6,171,29,70,0.414,2,6,0.333,27,64,0.422,0.429,18,22,0.818,8,11,19,18,1,0,8,15,78
2012,Tyler Hansbrough,PF,26,IND,11,0,164,17,50,0.34,0,0,0,17,50,0.34,0.34,14,21,0.667,12,23,35,6,5,3,8,22,48
2012,James Harden,SG,22,OKC,20,0,630,93,214,0.435,32,78,0.41,61,136,0.449,0.509,108,126,0.857,13,89,102,68,31,2,42,67,326
2012,Justin Harper,PF,22,ORL,1,0,5,0,1,0,0,0,0,0,1,0,0,0,0,0,0,0,0,0,0,0,0,0,0
2012,Josh Harrellson,PF,22,NYK,4,0,25,4,9,0.444,0,1,0,4,8,0.5,0.444,2,2,1,3,5,8,0,0,0,2,6,10
2012,Al Harrington,PF,31,DEN,7,0,163,24,75,0.32,10,35,0.286,14,40,0.35,0.387,10,15,0.667,7,23,30,6,3,1,3,13,68
2012,Devin Harris,PG,28,UTA,4,4,120,19,48,0.396,4,15,0.267,15,33,0.455,0.438,10,14,0.714,0,6,6,15,3,2,12,14,52
2012,Terrel Harris,SG,24,MIA,4,0,10,1,2,0.5,0,1,0,1,1,1,0.5,3,4,0.75,0,3,3,0,0,0,0,0,5
2012,Udonis Haslem,PF,31,MIA,22,11,452,40,88,0.455,0,0,0,40,88,0.455,0.455,26,35,0.743,37,104,141,13,5,6,20,60,106
2012,Spencer Hawes,C,23,PHI,13,12,332,50,108,0.463,2,5,0.4,48,103,0.466,0.472,19,26,0.731,18,68,86,21,4,11,22,32,121
2012,Gordon Hayward,SF,21,UTA,4,4,123,6,33,0.182,1,12,0.083,5,21,0.238,0.197,16,16,1,2,9,11,12,3,0,3,4,29
2012,Lazar Hayward,SF,25,OKC,5,0,18,2,3,0.667,0,0,0,2,3,0.667,0.667,0,0,0,0,4,4,0,0,0,1,2,4
2012,Brendan Haywood,C,32,DAL,4,4,61,4,14,0.286,0,0,0,4,14,0.286,0.286,5,8,0.625,7,6,13,1,1,2,2,8,13
2012,Roy Hibbert,C,25,IND,11,11,340,52,104,0.5,1,1,1,51,103,0.495,0.505,24,36,0.667,45,78,123,12,4,34,22,38,129
2012,George Hill,PG,25,IND,11,11,346,47,105,0.448,15,40,0.375,32,65,0.492,0.519,39,46,0.848,9,16,25,32,13,3,22,21,148
2012,Jordan Hill,C,24,LAL,12,0,217,23,53,0.434,0,0,0,23,53,0.434,0.434,11,16,0.688,39,37,76,1,3,8,7,32,57
2012,Kirk Hinrich,SG,31,ATL,6,4,141,13,30,0.433,6,16,0.375,7,14,0.5,0.533,2,2,1,4,8,12,6,4,0,2,9,34
2012,Jrue Holiday,PG,21,PHI,13,13,494,74,179,0.413,20,49,0.408,54,130,0.415,0.469,38,44,0.864,17,44,61,67,20,8,26,24,206
2012,Ryan Hollins,C,27,BOS,17,0,170,11,26,0.423,0,0,0,11,26,0.423,0.423,4,9,0.444,16,11,27,8,0,8,7,29,26
2012,Al Horford,C,25,ATL,3,2,108,20,34,0.588,0,0,0,20,34,0.588,0.588,6,8,0.75,5,20,25,8,4,4,12,11,46
2012,Josh Howard,SF,31,UTA,4,3,63,5,17,0.294,1,2,0.5,4,15,0.267,0.324,4,5,0.8,4,10,14,4,2,1,2,3,15
2012,Juwan Howard,PF,38,MIA,9,0,24,2,7,0.286,0,0,0,2,7,0.286,0.286,3,4,0.75,0,1,1,0,0,0,0,0,7
2012,Serge Ibaka,PF,22,OKC,20,20,569,84,159,0.528,1,4,0.25,83,155,0.535,0.531,26,36,0.722,47,68,115,12,11,59,11,57,195
2012,Andre Iguodala,SF,28,PHI,13,13,505,58,151,0.384,19,49,0.388,39,102,0.382,0.447,33,56,0.589,17,57,74,48,19,5,19,32,168
2012,Royal Ivey,SG,30,OKC,5,0,21,4,11,0.364,2,5,0.4,2,6,0.333,0.455,1,2,0.5,1,2,3,1,2,0,1,2,11
2012,Stephen Jackson,SF,33,SAS,14,0,299,38,71,0.535,26,43,0.605,12,28,0.429,0.718,14,15,0.933,5,23,28,24,9,3,18,38,116
2012,LeBron James,SF,27,MIA,23,23,983,251,502,0.5,22,85,0.259,229,417,0.549,0.522,173,234,0.739,54,170,224,129,43,16,81,47,697
2012,Al Jefferson,C,27,UTA,4,4,141,36,68,0.529,0,1,0,36,67,0.537,0.529,1,4,0.25,7,27,34,10,5,3,5,10,73
2012,Jared Jeffries,PF,30,NYK,5,0,34,1,6,0.167,0,0,0,1,6,0.167,0.167,0,0,0,6,6,12,0,1,0,1,5,2
2012,Yi Jianlian,PF,24,DAL,1,0,5,1,3,0.333,0,1,0,1,2,0.5,0.333,0,1,0,0,2,2,0,1,0,0,0,2
2012,Ivan Johnson,PF,27,ATL,5,0,54,5,16,0.313,0,1,0,5,15,0.333,0.313,3,5,0.6,7,10,17,0,3,0,3,7,13
2012,Joe Johnson,SG,30,ATL,6,6,243,38,102,0.373,9,36,0.25,29,66,0.439,0.417,18,24,0.75,6,15,21,21,8,1,16,11,103
2012,Dahntay Jones,SF,31,IND,7,0,58,4,18,0.222,2,9,0.222,2,9,0.222,0.278,7,7,1,4,3,7,3,1,0,3,11,17
2012,James Jones,SG,31,MIA,20,0,173,16,43,0.372,9,30,0.3,7,13,0.538,0.477,10,10,1,5,15,20,2,3,1,4,12,51
2012,DeAndre Jordan,C,23,LAC,11,11,249,21,40,0.525,0,0,0,21,40,0.525,0.525,8,24,0.333,18,40,58,4,7,18,7,20,50
2012,Jerome Jordan,C,25,NYK,1,0,4,1,2,0.5,0,0,0,1,2,0.5,0.5,0,0,0,2,0,2,0,0,0,0,0,2
2012,Enes Kanter,C,19,UTA,4,0,43,7,16,0.438,0,0,0,7,16,0.438,0.438,0,1,0,8,8,16,1,0,4,4,7,14
2012,Jason Kidd*,PG,38,DAL,4,4,144,14,41,0.341,9,26,0.346,5,15,0.333,0.451,9,10,0.9,3,21,24,24,12,1,11,7,46
2012,Kyle Korver,SG,30,CHI,6,0,94,9,22,0.409,4,13,0.308,5,9,0.556,0.5,1,2,0.5,1,9,10,9,3,3,5,10,23
2012,Kosta Koufos,C,22,DEN,3,2,26,1,3,0.333,0,0,0,1,3,0.333,0.333,0,0,0,4,7,11,0,0,1,3,5,2
2012,Ty Lawson,PG,24,DEN,7,7,242,56,109,0.514,9,28,0.321,47,81,0.58,0.555,12,19,0.632,4,14,18,42,7,1,8,12,133
2012,Kawhi Leonard,SF,20,SAS,14,14,379,45,90,0.5,18,40,0.45,27,50,0.54,0.6,13,16,0.813,18,65,83,8,17,6,13,23,121
2012,John Lucas III,PG,29,CHI,5,0,94,18,40,0.45,5,13,0.385,13,27,0.481,0.513,2,2,1,2,5,7,9,0,0,6,7,43
2012,Ian Mahinmi,C,25,DAL,4,0,70,9,14,0.643,0,0,0,9,14,0.643,0.643,11,13,0.846,9,9,18,0,3,3,1,13,29
2012,Shawn Marion,SF,33,DAL,4,4,140,17,40,0.425,4,14,0.286,13,26,0.5,0.475,9,10,0.9,9,23,32,4,1,5,10,14,47
2012,Kenyon Martin,PF,34,LAC,11,0,193,22,42,0.524,0,0,0,22,42,0.524,0.524,5,8,0.625,11,24,35,3,4,19,4,36,49
2012,O.J. Mayo,SG,24,MEM,7,0,163,17,62,0.274,7,24,0.292,10,38,0.263,0.331,21,27,0.778,2,23,25,15,9,1,18,18,62
2012,JaVale McGee,C,24,DEN,7,0,181,23,53,0.434,0,0,0,23,53,0.434,0.434,14,26,0.538,23,44,67,5,5,22,4,21,60
2012,Tracy McGrady*,SF,32,ATL,6,0,90,10,26,0.385,0,4,0,10,22,0.455,0.385,5,6,0.833,6,11,17,6,0,2,10,4,25
2012,Josh McRoberts,PF,24,LAL,6,0,16,1,4,0.25,0,1,0,1,3,0.333,0.25,0,0,0,0,4,4,1,0,1,2,1,2
2012,Jodie Meeks,SG,24,PHI,13,1,102,9,26,0.346,3,13,0.231,6,13,0.462,0.404,14,14,1,2,2,4,4,3,1,4,11,35
2012,Andre Miller,SG,35,DEN,7,0,200,31,73,0.425,4,7,0.571,27,66,0.409,0.452,13,15,0.867,14,25,39,42,9,1,17,19,79
2012,Mike Miller,SG,31,MIA,23,0,368,40,99,0.404,31,75,0.413,9,24,0.375,0.561,9,11,0.818,9,49,58,17,9,2,12,41,120
2012,Patty Mills,PG,23,SAS,8,0,31,6,11,0.545,3,5,0.6,3,6,0.5,0.682,0,0,0,1,2,3,5,1,0,3,2,15
2012,Paul Millsap,PF,26,UTA,4,4,139,20,54,0.37,0,3,0,20,51,0.392,0.37,8,16,0.5,17,27,44,2,1,10,9,11,48
2012,Nazr Mohammed,C,34,OKC,8,0,83,8,16,0.5,0,0,0,8,16,0.5,0.5,2,4,0.5,7,9,16,1,0,3,2,19,18
2012,E'Twaun Moore,PG,22,BOS,9,0,21,2,8,0.25,0,2,0,2,6,0.333,0.25,1,2,0.5,0,3,3,3,0,1,1,2,5
2012,Darius Morris,PG,21,LAL,4,0,8,3,3,1,1,1,1,2,2,1,1.167,3,4,0.75,0,0,0,3,0,0,1,1,10
2012,Timofey Mozgov,C,25,DEN,7,5,99,12,25,0.48,0,0,0,12,25,0.48,0.48,4,8,0.5,10,13,23,3,2,6,5,16,28
2012,Troy Murphy,PF,31,LAL,4,0,15,1,1,1,1,1,1,0,0,0,1.5,0,0,0,0,3,3,0,0,0,2,0,3
2012,Gary Neal,SG,27,SAS,14,0,217,39,82,0.476,16,36,0.444,23,46,0.5,0.573,11,13,0.846,1,17,18,19,2,0,11,21,105
2012,Jameer Nelson,PG,29,ORL,5,5,182,29,74,0.392,8,25,0.32,21,49,0.429,0.446,12,16,0.75,1,18,19,33,4,1,10,13,78
2012,Joakim Noah,C,26,CHI,3,3,99,19,26,0.731,0,0,0,19,26,0.731,0.731,7,11,0.636,9,19,28,9,2,4,1,5,45
2012,Steve Novak,PF,28,NYK,5,1,95,4,9,0.444,4,7,0.571,0,2,0,0.667,0,0,0,3,12,15,0,0,1,3,7,12
2012,Dirk Nowitzki,PF,33,DAL,4,4,154,34,77,0.442,1,6,0.167,33,71,0.465,0.448,38,42,0.905,3,22,25,7,3,0,10,9,107
2012,Daniel Orton,PF,21,ORL,4,0,9,0,0,,0,0,0,0,0,0,,4,4,1,0,2,2,0,0,0,0,3,4
2012,Jannero Pargo,PG,32,ATL,5,0,46,6,21,0.286,4,12,0.333,2,9,0.222,0.381,0,0,0,1,4,5,6,2,0,3,5,16
2012,Tony Parker,PG,29,SAS,14,14,506,102,225,0.453,7,21,0.333,95,204,0.466,0.469,71,88,0.807,8,42,50,95,13,0,44,23,282
2012,Chris Paul,PG,26,LAC,11,11,423,70,164,0.427,13,39,0.333,57,125,0.456,0.466,41,47,0.872,6,50,56,87,30,1,43,30,194
2012,Sasha Pavlovic,SF,28,BOS,10,0,40,3,9,0.333,1,5,0.2,2,4,0.5,0.389,0,0,0,2,3,5,1,1,1,4,4,7
2012,Kendrick Perkins,C,27,OKC,20,20,517,37,89,0.416,0,0,0,37,89,0.416,0.416,20,25,0.8,35,89,124,13,7,25,29,59,94
2012,Paul Pierce,SF,34,BOS,20,20,778,120,311,0.386,27,87,0.31,93,224,0.415,0.429,110,123,0.894,14,107,121,62,30,18,56,68,377
2012,Mickael Pietrus,SG,29,BOS,20,1,393,24,73,0.329,12,54,0.222,12,19,0.632,0.411,9,16,0.563,12,29,41,2,14,5,9,50,69
2012,Dexter Pittman,C,23,MIA,3,1,8,0,2,0,0,0,0,0,2,0,0,0,0,0,0,0,0,1,0,1,0,2,0
2012,Quincy Pondexter,SF,23,MEM,7,0,114,12,18,0.667,2,4,0.5,10,14,0.714,0.722,7,9,0.778,3,13,16,2,4,0,5,13,33
2012,A.J. Price,PG,25,IND,4,0,7,1,2,0.5,0,0,0,1,2,0.5,0.5,0,0,0,1,1,2,1,0,0,0,0,2
2012,Vladimir Radmanovic,SF,31,ATL,2,0,15,0,4,0,0,3,0,0,1,0,0,0,0,0,0,1,1,1,0,0,0,3,0
2012,Zach Randolph,PF,30,MEM,7,7,248,37,88,0.42,0,4,0,37,84,0.44,0.42,22,35,0.629,27,42,69,6,7,4,11,25,96
2012,J.J. Redick,SG,27,ORL,5,0,123,19,44,0.432,4,19,0.211,15,25,0.6,0.477,12,14,0.857,0,5,5,16,1,0,6,4,54
2012,Jason Richardson,SG,31,ORL,5,5,148,21,53,0.396,10,27,0.37,11,26,0.423,0.491,5,12,0.417,4,15,19,5,6,2,6,7,57
2012,Quentin Richardson,SF,31,ORL,5,0,74,5,15,0.333,2,7,0.286,3,8,0.375,0.4,0,0,0,0,22,22,2,1,0,6,6,12
2012,Rajon Rondo,PG,25,BOS,19,19,810,141,301,0.468,8,30,0.267,133,271,0.491,0.482,39,56,0.696,35,93,128,227,45,2,72,40,329
2012,Derrick Rose,PG,23,CHI,1,1,37,9,23,0.391,3,6,0.5,6,17,0.353,0.457,2,2,1,3,6,9,9,1,1,5,1,23
2012,Thabo Sefolosha,SG,27,OKC,20,20,446,41,102,0.402,16,49,0.327,25,53,0.472,0.48,8,9,0.889,11,42,53,26,30,9,11,44,106
2012,Josh Selby,PG,20,MEM,1,0,0,0,0,,0,0,0,0,0,0,,0,0,0,0,0,0,0,0,0,0,0,0
2012,Ramon Sessions,PG,25,LAL,12,12,380,43,114,0.377,4,25,0.16,39,89,0.438,0.395,26,35,0.743,3,33,36,43,4,1,22,27,116
2012,Iman Shumpert,PG,21,NYK,1,1,19,0,2,0,0,1,0,0,1,0,0,0,0,0,0,1,1,0,1,0,1,2,0
2012,Xavier Silas,SG,24,PHI,2,0,4,1,1,1,0,0,0,1,1,1,1,0,0,0,1,1,2,0,0,0,0,0,2
2012,Bobby Simmons,SF,31,LAC,4,1,32,5,9,0.556,1,4,0.25,4,5,0.8,0.611,0,0,0,0,1,1,0,0,0,1,7,11
2012,Ish Smith,PG,23,ORL,1,0,5,0,0,,0,0,0,0,0,0,,0,0,0,0,1,1,0,0,1,0,0,0
2012,J.R. Smith,SG,26,NYK,5,0,175,24,76,0.316,5,28,0.179,19,48,0.396,0.349,8,8,1,2,11,13,11,6,1,11,19,61
2012,Josh Smith,PF,26,ATL,5,5,196,34,88,0.386,0,4,0,34,84,0.405,0.386,16,21,0.762,10,58,68,24,3,5,15,14,84
2012,Marreese Speights,PF,24,MEM,7,0,100,20,41,0.488,0,0,0,20,41,0.488,0.488,6,10,0.6,13,17,30,2,3,3,5,13,46
2012,Tiago Splitter,C,27,SAS,13,0,168,30,47,0.638,0,0,0,30,47,0.638,0.638,16,43,0.372,8,28,36,10,5,4,9,24,76
2012,Lance Stephenson,SG,21,IND,4,0,12,2,9,0.222,1,2,0.5,1,7,0.143,0.278,1,2,0.5,0,0,0,1,0,0,2,2,6
2012,Greg Stiemsma,C,26,BOS,19,0,143,12,18,0.667,0,0,0,12,18,0.667,0.667,4,6,0.667,9,32,41,5,4,11,4,26,28
2012,Julyan Stone,SG,23,DEN,2,0,5,1,2,0.5,0,0,0,1,2,0.5,0.5,0,0,0,1,0,1,2,0,0,0,0,2
2012,Amar'e Stoudemire,PF,29,NYK,4,4,139,20,36,0.556,0,0,0,20,36,0.556,0.556,21,28,0.75,8,18,26,3,5,1,12,16,61
2012,Jeff Teague,PG,23,ATL,6,6,225,30,73,0.411,7,17,0.412,23,56,0.411,0.459,17,19,0.895,4,18,22,25,5,5,10,18,84
2012,Jason Terry,SG,34,DAL,4,1,139,20,44,0.455,10,20,0.5,10,24,0.417,0.568,5,8,0.625,1,8,9,15,1,0,8,11,55
2012,Jamaal Tinsley,PG,33,UTA,4,0,65,5,20,0.25,1,4,0.25,4,16,0.25,0.275,4,4,1,0,2,2,12,2,0,6,7,15
2012,Ronny Turiaf,C,29,MIA,12,7,121,10,18,0.556,0,0,0,10,18,0.556,0.556,3,11,0.273,11,20,31,1,1,8,6,23,23
2012,Hedo Turkoglu,SF,32,ORL,5,5,162,15,41,0.366,5,12,0.417,10,29,0.345,0.427,7,11,0.636,4,10,14,12,5,4,9,18,42
2012,Evan Turner,SF,23,PHI,13,12,449,56,154,0.364,0,6,0,56,148,0.378,0.364,33,48,0.688,14,84,98,32,12,6,30,36,145
2012,Nikola Vucevic,C,21,PHI,1,0,3,0,1,0,0,0,0,0,1,0,0,1,2,0.5,0,1,1,0,0,0,0,0,1
2012,Dwyane Wade,SG,30,MIA,23,23,907,197,426,0.462,10,34,0.294,187,392,0.477,0.474,121,166,0.729,32,88,120,100,39,30,68,65,525
2012,Von Wafer,SG,26,ORL,1,0,6,3,5,0.6,0,0,0,3,5,0.6,0.6,0,0,0,0,1,1,0,0,0,1,1,6
2012,C.J. Watson,PG,27,CHI,6,5,164,14,58,0.241,4,16,0.25,10,42,0.238,0.276,12,16,0.75,1,12,13,33,5,0,7,16,44
2012,David West,PF,31,IND,11,11,416,66,148,0.446,0,0,0,66,148,0.446,0.446,36,44,0.818,21,73,94,22,8,6,17,33,168
2012,Delonte West,PG,28,DAL,4,3,88,11,26,0.423,3,6,0.5,8,20,0.4,0.481,5,5,1,2,5,7,8,3,0,3,5,30
2012,Russell Westbrook,PG,23,OKC,20,20,767,177,407,0.435,18,65,0.277,159,342,0.465,0.457,89,111,0.802,22,87,109,117,31,8,45,49,461
2012,Lou Williams,PG,25,PHI,13,0,358,50,142,0.352,8,48,0.167,42,94,0.447,0.38,41,52,0.788,3,24,27,39,13,0,16,17,149
2012,Marvin Williams,SF,25,ATL,6,3,145,16,45,0.356,8,16,0.5,8,29,0.276,0.444,7,9,0.778,5,28,33,5,3,2,3,9,47
2012,Mo Williams,SG,29,LAC,11,0,229,41,94,0.436,12,33,0.364,29,61,0.475,0.5,12,13,0.923,1,8,9,15,6,5,12,16,106
2012,Sean Williams,C,25,BOS,2,0,6,0,0,,0,0,0,0,0,0,,0,0,0,0,1,1,0,0,0,1,1,0
2012,Metta World Peace,SF,32,LAL,6,6,236,22,60,0.367,14,36,0.389,8,24,0.333,0.483,12,16,0.75,3,18,21,14,13,4,5,18,70
2012,Brandan Wright,C,24,DAL,4,0,27,2,5,0.4,0,0,0,2,5,0.4,0.4,1,2,0.5,2,3,5,0,1,1,3,4,5
2012,Nick Young,SG,26,LAC,11,0,200,29,67,0.433,17,33,0.515,12,34,0.353,0.56,16,18,0.889,1,11,12,3,3,4,7,20,91
2012,Sam Young,SF,26,PHI,2,0,4,0,2,0,0,1,0,0,1,0,0,0,0,0,0,0,0,0,0,0,0,0,0
2012,Thaddeus Young,PF,23,PHI,13,0,277,39,91,0.429,0,0,0,39,91,0.429,0.429,22,31,0.71,25,43,68,15,7,7,15,25,100
2013,Ray Allen*,SG,37,MIA,23,0,573,74,172,0.43,39,96,0.406,35,76,0.461,0.544,47,54,0.87,13,51,64,29,12,3,27,42,234
2013,Tony Allen,SG,31,MEM,15,15,422,54,125,0.432,2,8,0.25,52,117,0.444,0.44,44,58,0.759,37,54,91,27,30,5,19,48,154
2013,Chris Andersen,C,34,MIA,20,0,303,46,57,0.807,0,0,0,46,57,0.807,0.807,36,49,0.735,32,44,76,3,9,22,11,53,128
2013,James Anderson,SG,23,HOU,2,0,18,1,5,0.2,0,3,0,1,2,0.5,0.2,0,0,0,1,3,4,0,0,0,0,2,2
2013,Carmelo Anthony,PF,28,NYK,12,12,481,126,310,0.406,17,57,0.298,109,253,0.431,0.434,77,87,0.885,11,68,79,19,13,2,31,46,346
2013,Joel Anthony,C,30,MIA,14,0,71,3,10,0.3,0,0,0,3,10,0.3,0.3,0,0,0,10,11,21,0,2,4,3,13,6
2013,Darrell Arthur,PF,24,MEM,15,0,175,25,53,0.472,0,2,0,25,51,0.49,0.472,8,9,0.889,14,24,38,6,2,4,7,36,58
2013,Omer Asik,C,26,HOU,6,6,208,22,39,0.564,0,0,0,22,39,0.564,0.564,30,47,0.638,21,46,67,3,3,10,12,22,74
2013,D.J. Augustin,PG,25,IND,19,1,316,27,71,0.38,19,48,0.396,8,23,0.348,0.514,25,31,0.806,2,13,15,13,7,0,10,26,98
2013,Gustavo Ayon,C,27,MIL,3,0,7,2,4,0.5,0,0,0,2,4,0.5,0.5,0,0,0,0,0,0,0,0,0,0,0,4
2013,Jeff Ayres,PF,25,IND,9,0,71,8,24,0.333,0,1,0,8,23,0.348,0.333,0,0,0,4,14,18,1,0,2,3,14,16
2013,Harrison Barnes,SF,20,GSW,12,12,461,72,162,0.444,19,52,0.365,53,110,0.482,0.503,30,35,0.857,18,59,77,15,7,5,16,33,193
2013,Matt Barnes,SF,32,LAC,6,0,162,24,44,0.545,7,17,0.412,17,27,0.63,0.625,16,19,0.842,7,23,30,3,4,2,5,23,71
2013,Brandon Bass,PF,27,BOS,6,5,204,14,29,0.483,0,0,0,14,29,0.483,0.483,12,15,0.8,8,32,40,7,2,1,5,17,40
2013,Shane Battier,SF,34,MIA,22,0,392,27,93,0.29,26,88,0.295,1,5,0.2,0.43,23,28,0.821,9,29,38,12,5,6,5,49,103
2013,Jerryd Bayless,PG,24,MEM,15,0,320,49,137,0.358,18,59,0.305,31,78,0.397,0.423,23,26,0.885,1,29,30,32,7,5,16,35,139
2013,Aron Baynes,C,26,SAS,4,1,23,4,7,0.571,0,0,0,4,7,0.571,0.571,0,0,0,2,3,5,0,0,0,1,4,8
2013,Kent Bazemore,SG,23,GSW,9,0,16,1,8,0.125,0,1,0,1,7,0.143,0.125,0,4,0,1,4,5,2,1,0,2,3,2
2013,Marco Belinelli,SG,26,CHI,12,7,325,44,107,0.411,16,47,0.34,28,60,0.467,0.486,29,33,0.879,0,35,35,31,5,0,15,26,133
2013,Patrick Beverley,PG,24,HOU,6,5,200,28,65,0.431,8,24,0.333,20,41,0.488,0.492,7,7,1,11,22,33,17,7,4,6,24,71
2013,Andris Biedrins,C,26,GSW,3,0,17,0,0,,0,0,0,0,0,0,,0,0,0,2,5,7,1,0,2,1,6,0
2013,Chauncey Billups,SG,36,LAC,6,6,115,11,36,0.306,6,17,0.353,5,19,0.263,0.389,9,11,0.818,2,10,12,6,1,1,8,10,37
2013,DeJuan Blair,PF,23,SAS,12,0,76,21,34,0.618,0,0,0,21,34,0.618,0.618,5,9,0.556,6,18,24,7,5,1,1,14,47
2013,Steve Blake,PG,32,LAL,2,2,75,11,28,0.393,5,12,0.417,6,16,0.375,0.482,1,1,1,0,8,8,5,4,3,4,8,28
2013,Andray Blatche,C,26,BRK,7,0,138,29,58,0.5,0,0,0,29,58,0.5,0.5,14,17,0.824,10,24,34,9,2,3,5,14,72
2013,Eric Bledsoe,PG,23,LAC,6,0,97,15,30,0.5,1,9,0.111,14,21,0.667,0.517,8,12,0.667,2,13,15,18,2,3,5,10,39
2013,Keith Bogans,SG,32,BRK,2,0,23,0,1,0,0,1,0,0,0,0,0,0,0,0,0,2,2,2,0,0,1,3,0
2013,Andrew Bogut,C,28,GSW,12,12,327,39,67,0.582,0,0,0,39,67,0.582,0.582,8,23,0.348,39,92,131,22,6,18,22,39,86
2013,Matt Bonner,PF,32,SAS,20,1,267,28,59,0.475,15,32,0.469,13,27,0.481,0.602,10,12,0.833,9,30,39,6,5,5,2,35,81
2013,Carlos Boozer,PF,31,CHI,12,12,431,83,168,0.494,0,1,0,83,167,0.497,0.494,31,45,0.689,35,80,115,18,10,1,29,36,197
2013,Chris Bosh,C,28,MIA,23,23,751,110,240,0.458,15,37,0.405,95,203,0.468,0.49,44,60,0.733,38,129,167,34,23,36,27,67,279
2013,Avery Bradley,PG,22,BOS,6,6,191,17,42,0.405,2,8,0.25,15,34,0.441,0.429,4,4,1,3,10,13,8,11,1,11,11,40
2013,Corey Brewer,SF,26,DEN,6,0,146,21,68,0.309,9,36,0.25,12,32,0.375,0.375,14,21,0.667,3,8,11,7,6,1,7,19,65
2013,Ronnie Brewer,SF,27,OKC,1,0,8,0,0,,0,0,0,0,0,0,,0,0,0,0,1,1,0,0,0,0,1,0
2013,Aaron Brooks,PG,28,HOU,6,0,67,13,34,0.382,1,9,0.111,12,25,0.48,0.397,3,5,0.6,3,6,9,11,1,1,6,3,30
2013,MarShon Brooks,SG,24,BRK,7,0,40,3,8,0.375,0,1,0,3,7,0.429,0.375,2,2,1,1,4,5,3,0,0,3,3,8
2013,Caron Butler,SF,32,LAC,6,6,136,22,46,0.478,4,16,0.25,18,30,0.6,0.522,3,3,1,1,15,16,0,2,2,6,11,51
2013,Jimmy Butler,SF,23,CHI,12,12,490,50,115,0.435,15,37,0.405,35,78,0.449,0.5,45,55,0.818,9,53,62,32,15,6,16,26,160
2013,Marcus Camby,PF,38,NYK,3,0,3,1,1,1,0,0,0,1,1,1,1,0,0,0,1,1,2,0,0,0,1,1,2
2013,Mario Chalmers,PG,26,MIA,23,23,650,76,183,0.415,24,68,0.353,52,115,0.452,0.481,40,53,0.755,10,43,53,71,21,1,38,70,216
2013,Tyson Chandler,C,30,NYK,12,12,350,28,52,0.538,0,0,0,28,52,0.538,0.538,12,16,0.75,40,48,88,4,8,14,11,48,68
2013,Wilson Chandler,PF,25,DEN,6,6,205,27,76,0.355,9,29,0.31,18,47,0.383,0.414,9,12,0.75,5,28,33,8,8,3,7,25,72
2013,Earl Clark,PF,25,LAL,4,1,82,7,19,0.368,0,4,0,7,15,0.467,0.368,0,0,0,2,10,12,1,1,1,6,4,14
2013,Norris Cole,PG,24,MIA,21,0,418,49,102,0.48,17,32,0.531,32,70,0.457,0.564,14,19,0.737,6,33,39,42,15,2,23,40,129
2013,Nick Collison,C,32,OKC,11,0,178,22,47,0.468,0,0,0,22,47,0.468,0.468,11,12,0.917,25,26,51,12,5,11,10,37,55
2013,Mike Conley,PG,25,MEM,15,15,575,83,216,0.384,18,64,0.281,65,152,0.428,0.426,71,93,0.763,12,59,71,107,26,5,34,34,255
2013,Daequan Cook,SG,25,CHI,6,0,36,1,10,0.1,1,8,0.125,0,2,0,0.15,0,0,0,0,3,3,4,1,0,4,6,3
2013,Chris Copeland,PF,28,NYK,9,1,93,12,30,0.4,11,23,0.478,1,7,0.143,0.583,2,2,1,2,7,9,1,5,0,4,9,37
2013,Jamal Crawford,SG,32,LAC,6,0,161,24,62,0.387,6,22,0.273,18,40,0.45,0.435,11,11,1,2,10,12,10,3,1,4,9,65
2013,Jordan Crawford,SG,24,BOS,5,0,59,7,23,0.304,3,12,0.25,4,11,0.364,0.37,1,2,0.5,0,3,3,0,2,0,3,3,18
2013,Stephen Curry,PG,24,GSW,12,12,497,102,235,0.434,42,106,0.396,60,129,0.465,0.523,35,38,0.921,5,41,46,97,20,2,40,35,281
2013,Samuel Dalembert,C,31,MIL,1,0,9,0,2,0,0,0,0,0,2,0,0,1,4,0.25,1,2,3,0,1,0,2,3,1
2013,Marquis Daniels,SF,32,MIL,3,0,33,6,11,0.545,0,2,0,6,9,0.667,0.545,0,0,0,0,4,4,4,1,0,1,3,12
2013,Ed Davis,PF,23,MEM,8,0,48,5,12,0.417,0,0,0,5,12,0.417,0.417,3,4,0.75,4,7,11,0,0,1,2,7,13
2013,Austin Daye,SF,24,MEM,4,0,20,3,8,0.375,0,1,0,3,7,0.429,0.375,1,1,1,0,1,1,0,0,1,1,2,7
2013,Nando De Colo,SG,25,SAS,5,0,14,1,4,0.25,0,3,0,1,1,1,0.25,2,2,1,2,2,4,2,0,0,0,1,4
2013,Carlos Delfino,SF,30,HOU,5,0,120,15,40,0.375,11,31,0.355,4,9,0.444,0.513,4,4,1,1,11,12,10,3,1,5,10,45
2013,Luol Deng,SF,27,CHI,5,5,224,32,84,0.381,1,18,0.056,31,66,0.47,0.387,4,10,0.4,5,33,38,19,5,3,12,12,69
2013,Boris Diaw,PF,30,SAS,16,1,273,24,54,0.444,5,13,0.385,19,41,0.463,0.491,12,14,0.857,8,32,40,28,4,3,13,28,65
2013,Keyon Dooling,PG,32,MEM,14,0,114,8,24,0.333,5,13,0.385,3,11,0.273,0.438,6,6,1,0,5,5,4,1,0,3,14,27
2013,Chris Duhon,PG,30,LAL,2,0,68,4,11,0.364,3,8,0.375,1,3,0.333,0.5,0,0,0,1,2,3,7,2,1,5,4,11
2013,Tim Duncan,C,36,SAS,21,21,735,151,321,0.47,0,1,0,151,320,0.472,0.47,79,98,0.806,54,160,214,40,18,34,42,53,381
2013,Mike Dunleavy,SF,32,MIL,4,0,91,17,30,0.567,7,16,0.438,10,14,0.714,0.683,8,9,0.889,3,13,16,8,2,0,3,5,49
2013,Kevin Durant,SF,24,OKC,11,11,485,112,246,0.455,22,70,0.314,90,176,0.511,0.5,93,112,0.83,7,92,99,69,14,12,43,26,339
2013,Monta Ellis,SG,27,MIL,4,4,152,24,55,0.436,3,19,0.158,21,36,0.583,0.464,6,16,0.375,2,11,13,22,10,1,14,8,57
2013,Reggie Evans,PF,32,BRK,7,7,209,11,23,0.478,0,0,0,11,23,0.478,0.478,10,18,0.556,16,70,86,6,7,2,6,21,32
2013,Festus Ezeli,C,23,GSW,12,3,134,6,13,0.462,0,0,0,6,13,0.462,0.462,12,21,0.571,13,17,30,2,3,7,12,24,24
2013,Kenneth Faried,PF,23,DEN,5,4,145,20,32,0.625,0,0,0,20,32,0.625,0.625,11,15,0.733,12,30,42,1,5,1,5,22,51
2013,Raymond Felton,PG,28,NYK,12,12,454,72,162,0.444,9,28,0.321,63,134,0.47,0.472,16,24,0.667,17,24,41,56,20,5,20,26,169
2013,Derek Fisher,SG,38,OKC,11,0,261,32,70,0.457,24,51,0.471,8,19,0.421,0.629,8,12,0.667,1,16,17,8,7,1,8,33,96
2013,Evan Fournier,SG,20,DEN,4,4,53,6,17,0.353,0,8,0,6,9,0.667,0.353,7,8,0.875,0,0,0,4,2,0,6,6,19
2013,Francisco Garcia,SF,31,HOU,6,3,164,22,50,0.44,17,37,0.459,5,13,0.385,0.61,3,5,0.6,3,17,20,9,4,5,4,21,64
2013,Kevin Garnett,C,36,BOS,6,6,212,30,60,0.5,0,2,0,30,58,0.517,0.5,16,17,0.941,9,73,82,21,5,6,19,23,76
2013,Marc Gasol,C,28,MEM,15,15,609,93,205,0.454,0,0,0,93,205,0.454,0.454,72,90,0.8,25,102,127,48,13,33,18,53,258
2013,Pau Gasol,PF,32,LAL,4,4,146,25,52,0.481,0,0,0,25,52,0.481,0.481,6,11,0.545,7,39,46,26,2,3,13,4,56
2013,Paul George,SF,22,IND,19,19,780,119,277,0.43,34,104,0.327,85,173,0.491,0.491,93,128,0.727,16,125,141,96,25,9,75,72,365
2013,Taj Gibson,PF,27,CHI,12,0,206,31,66,0.47,0,2,0,31,64,0.484,0.47,16,22,0.727,15,21,36,4,4,6,9,37,78
2013,Manu Ginobili,SG,35,SAS,21,3,560,77,193,0.399,29,96,0.302,48,97,0.495,0.474,59,80,0.738,9,69,78,105,24,6,55,52,242
2013,Andrew Goudelock,SG,24,LAL,3,2,80,16,36,0.444,2,10,0.2,14,26,0.538,0.472,2,2,1,1,4,5,3,5,0,4,7,36
2013,Danny Green,SG,25,SAS,21,21,669,83,186,0.446,55,114,0.482,28,72,0.389,0.594,12,15,0.8,18,69,87,32,22,23,19,51,233
2013,Draymond Green,SF,22,GSW,12,1,223,24,56,0.429,9,23,0.391,15,33,0.455,0.509,13,17,0.765,14,37,51,19,6,10,12,35,70
2013,Gerald Green,SF,27,IND,9,0,105,21,50,0.42,11,33,0.333,10,17,0.588,0.53,2,2,1,2,10,12,3,0,1,6,10,55
2013,Jeff Green,PF,26,BOS,6,6,258,37,85,0.435,10,22,0.455,27,63,0.429,0.494,38,45,0.844,6,26,32,14,2,4,19,22,122
2013,Willie Green,SG,31,LAC,3,0,20,2,3,0.667,0,1,0,2,2,1,0.667,2,2,1,0,3,3,2,1,0,0,0,6
2013,Blake Griffin,PF,23,LAC,6,5,158,29,64,0.453,0,0,0,29,64,0.453,0.453,21,26,0.808,8,25,33,15,0,5,13,24,79
2013,Jordan Hamilton,SF,22,DEN,1,0,2,0,1,0,0,0,0,0,1,0,0,0,0,0,0,0,0,0,0,0,0,0,0
2013,Richard Hamilton,SG,34,CHI,4,0,68,10,27,0.37,3,7,0.429,7,20,0.35,0.426,3,4,0.75,0,3,3,5,1,2,5,5,26
2013,Ben Hansbrough,PG,25,IND,6,0,22,0,5,0,0,3,0,0,2,0,0,0,0,0,1,2,3,3,0,1,2,2,0
2013,Tyler Hansbrough,PF,27,IND,19,0,241,26,62,0.419,0,0,0,26,62,0.419,0.419,26,44,0.591,36,25,61,5,6,0,15,41,78
2013,James Harden,SG,23,HOU,6,6,243,45,115,0.391,15,44,0.341,30,71,0.423,0.457,53,66,0.803,5,35,40,27,12,6,27,18,158
2013,Devin Harris,SG,29,ATL,6,6,225,23,63,0.365,5,25,0.2,18,38,0.474,0.405,17,25,0.68,2,15,17,22,10,1,12,18,68
2013,Udonis Haslem,PF,32,MIA,22,19,357,51,86,0.593,0,0,0,51,86,0.593,0.593,8,14,0.571,26,54,80,6,15,5,14,54,110
2013,John Henson,PF,22,MIL,4,0,33,3,11,0.273,0,1,0,3,10,0.3,0.273,0,0,0,0,8,8,1,2,0,2,5,6
2013,Roy Hibbert,C,26,IND,19,19,694,120,235,0.511,0,0,0,120,235,0.511,0.511,83,103,0.806,90,98,188,26,3,37,43,74,323
2013,George Hill,PG,26,IND,18,18,685,83,207,0.401,34,95,0.358,49,112,0.438,0.483,63,76,0.829,5,62,67,77,22,4,40,41,263
2013,Grant Hill*,SF,40,LAC,1,0,20,2,4,0.5,0,0,0,2,4,0.5,0.5,0,0,0,2,2,4,2,0,0,1,5,4
2013,Jordan Hill,PF,25,LAL,3,0,31,5,10,0.5,0,0,0,5,10,0.5,0.5,0,0,0,2,9,11,1,0,2,0,2,10
2013,Kirk Hinrich,PG,32,CHI,4,4,162,16,37,0.432,4,11,0.364,12,26,0.462,0.486,9,14,0.643,1,10,11,23,8,1,8,14,45
2013,Ryan Hollins,C,28,LAC,5,0,37,5,9,0.556,0,0,0,5,9,0.556,0.556,1,2,0.5,3,2,5,2,0,2,2,10,11
2013,Al Horford,C,26,ATL,6,6,218,41,83,0.494,0,0,0,41,83,0.494,0.494,18,27,0.667,12,41,53,18,6,5,9,17,100
2013,Dwight Howard,C,27,LAL,4,4,126,26,42,0.619,0,0,0,26,42,0.619,0.619,16,36,0.444,10,33,43,4,2,8,16,17,68
2013,Kris Humphries,PF,27,BRK,7,0,83,14,31,0.452,0,0,0,14,31,0.452,0.452,3,7,0.429,10,13,23,1,1,3,2,15,31
2013,Serge Ibaka,PF,23,OKC,11,11,366,59,135,0.437,4,9,0.444,55,126,0.437,0.452,19,24,0.792,39,53,92,8,0,33,7,38,141
2013,Andre Iguodala,SG,29,DEN,6,6,243,38,76,0.5,14,29,0.483,24,47,0.511,0.592,18,25,0.72,9,39,48,32,12,2,17,9,108
2013,Ersan Ilyasova,PF,25,MIL,4,4,117,20,46,0.435,4,10,0.4,16,36,0.444,0.478,2,2,1,10,19,29,7,5,1,6,8,46
2013,Jarrett Jack,SG,29,GSW,12,4,426,78,154,0.506,7,24,0.292,71,130,0.546,0.529,43,48,0.896,7,46,53,56,11,4,38,26,206
2013,Reggie Jackson,PG,22,OKC,11,9,368,57,119,0.479,13,43,0.302,44,76,0.579,0.534,26,29,0.897,4,50,54,40,5,6,21,34,153
2013,LeBron James,PF,28,MIA,23,23,960,212,432,0.491,36,96,0.375,176,336,0.524,0.532,136,175,0.777,37,156,193,152,41,18,70,43,596
2013,Antawn Jamison,PF,36,LAL,4,0,79,10,23,0.435,5,12,0.417,5,11,0.455,0.543,4,6,0.667,1,6,7,1,1,2,3,9,29
2013,Richard Jefferson,SF,32,GSW,7,0,39,4,9,0.444,2,3,0.667,2,6,0.333,0.556,3,9,0.333,2,5,7,1,1,1,0,5,13
2013,John Jenkins,SG,21,ATL,4,0,24,0,3,0,0,1,0,0,2,0,0,0,0,0,0,2,2,3,0,0,2,2,0
2013,Brandon Jennings,PG,23,MIL,4,4,133,17,57,0.298,6,28,0.214,11,29,0.379,0.351,13,18,0.722,1,8,9,16,9,1,11,6,53
2013,Ivan Johnson,PF,28,ATL,6,0,108,12,26,0.462,0,0,0,12,26,0.462,0.462,12,18,0.667,9,11,20,3,4,3,6,23,36
2013,Joe Johnson,SG,31,BRK,7,7,271,43,103,0.417,10,39,0.256,33,64,0.516,0.466,8,9,0.889,4,18,22,19,8,0,12,13,104
2013,Orlando Johnson,SG,23,IND,12,0,28,2,11,0.182,1,3,0.333,1,8,0.125,0.227,5,9,0.556,0,3,3,1,0,0,1,0,10
2013,Dahntay Jones,SF,32,ATL,5,0,19,1,4,0.25,0,0,0,1,4,0.25,0.25,2,2,1,0,1,1,0,0,0,1,1,4
2013,Dwayne Jones,PF,29,GSW,2,0,2,0,0,,0,0,0,0,0,0,,0,0,0,0,0,0,0,0,0,0,0,0
2013,James Jones,SF,32,MIA,9,0,33,3,7,0.429,3,4,0.75,0,3,0,0.643,0,0,0,0,3,3,0,0,1,2,3,9
2013,Perry Jones,SF,21,OKC,1,0,5,0,1,0,0,0,0,0,1,0,0,0,0,0,0,1,1,0,0,0,0,0,0
2013,Terrence Jones,PF,21,HOU,2,0,35,4,10,0.4,0,2,0,4,8,0.5,0.4,0,3,0,5,10,15,1,0,1,1,2,8
2013,DeAndre Jordan,C,24,LAC,6,6,144,10,22,0.455,0,0,0,10,22,0.455,0.455,2,9,0.222,15,23,38,1,1,10,9,18,22
2013,Cory Joseph,PG,21,SAS,20,0,192,26,56,0.464,2,11,0.182,24,45,0.533,0.482,5,11,0.455,8,23,31,24,6,2,10,15,59
2013,Jason Kidd*,SG,39,NYK,12,0,247,3,25,0.12,3,17,0.176,0,8,0,0.18,2,2,1,7,35,42,24,12,4,13,12,11
2013,Kyle Korver,SF,31,ATL,6,2,177,19,49,0.388,12,34,0.353,7,15,0.467,0.51,11,12,0.917,0,20,20,4,2,4,6,14,61
2013,Kosta Koufos,C,23,DEN,6,2,100,7,19,0.368,1,1,1,6,18,0.333,0.395,5,6,0.833,9,12,21,3,3,4,2,13,20
2013,Carl Landry,PF,29,GSW,12,3,246,52,100,0.52,0,0,0,52,100,0.52,0.52,38,52,0.731,22,40,62,17,7,2,19,29,142
2013,Ty Lawson,PG,25,DEN,6,6,236,48,109,0.44,4,21,0.19,44,88,0.5,0.459,28,33,0.848,5,15,20,48,10,0,13,13,128
2013,Courtney Lee,SG,27,BOS,4,0,39,1,5,0.2,0,2,0,1,3,0.333,0.2,4,4,1,0,2,2,1,2,0,0,3,6
2013,David Lee,PF,29,GSW,6,1,65,13,33,0.394,0,0,0,13,33,0.394,0.394,4,6,0.667,6,22,28,5,3,1,5,5,30
2013,Kawhi Leonard,SF,21,SAS,21,21,775,115,211,0.545,23,59,0.39,92,152,0.605,0.6,31,49,0.633,50,140,190,22,37,11,23,40,284
2013,Jon Leuer,PF,23,MEM,5,0,11,1,2,0.5,0,0,0,1,2,0.5,0.5,0,0,0,2,1,3,0,1,1,0,1,2
2013,Rashard Lewis,PF,33,MIA,11,0,47,8,20,0.4,0,4,0,8,16,0.5,0.4,1,2,0.5,1,6,7,4,2,2,6,5,17
2013,DeAndre Liggins,SG,24,OKC,8,0,68,3,9,0.333,1,5,0.2,2,4,0.5,0.389,1,4,0.25,0,14,14,4,1,1,2,10,8
2013,Jeremy Lin,PG,24,HOU,4,3,84,6,24,0.25,2,12,0.167,4,12,0.333,0.292,2,2,1,0,8,8,8,2,1,8,9,16
2013,Brook Lopez,C,24,BRK,7,7,263,58,123,0.472,1,1,1,57,122,0.467,0.476,39,44,0.886,29,23,52,10,6,21,16,20,156
2013,Scott Machado,PG,22,GSW,5,0,8,1,2,0.5,0,0,0,1,2,0.5,0.5,1,2,0.5,0,1,1,1,0,0,1,1,3
2013,Shelvin Mack,PG,22,ATL,4,0,22,4,9,0.444,2,5,0.4,2,4,0.5,0.556,0,0,0,3,4,7,7,0,0,0,0,10
2013,Ian Mahinmi,C,26,IND,18,0,150,13,29,0.448,0,0,0,13,29,0.448,0.448,3,10,0.3,20,22,42,1,0,13,12,28,29
2013,Kenyon Martin,C,35,NYK,12,1,253,29,50,0.58,0,0,0,29,50,0.58,0.58,11,20,0.55,16,38,54,11,9,17,8,42,69
2013,Kevin Martin,SG,29,OKC,11,0,323,49,129,0.38,17,46,0.37,32,83,0.386,0.446,39,43,0.907,2,32,34,14,7,3,11,18,154
2013,Luc Mbah a Moute,SF,26,MIL,4,4,136,10,23,0.435,0,4,0,10,19,0.526,0.435,13,18,0.722,4,10,14,7,4,0,5,9,33
2013,JaVale McGee,C,25,DEN,6,2,112,18,31,0.581,0,0,0,18,31,0.581,0.581,7,18,0.389,17,14,31,0,4,6,11,17,43
2013,Tracy McGrady*,SF,33,SAS,6,0,31,0,7,0,0,3,0,0,4,0,0,0,0,0,1,7,8,7,2,3,2,1,0
2013,Jodie Meeks,SG,25,LAL,1,0,20,1,4,0.25,0,2,0,1,2,0.5,0.25,2,2,1,1,1,2,0,1,0,2,2,4
2013,Andre Miller,PG,36,DEN,6,0,154,29,69,0.42,5,11,0.455,24,58,0.414,0.457,21,27,0.778,11,9,20,23,2,0,16,8,84
2013,Mike Miller,SF,32,MIA,17,5,232,21,45,0.467,16,36,0.444,5,9,0.556,0.644,0,0,0,3,30,33,15,8,2,5,26,58
2013,Patty Mills,PG,24,SAS,9,0,31,5,10,0.5,2,7,0.286,3,3,1,0.6,0,0,0,1,2,3,2,0,0,1,2,12
2013,Nazr Mohammed,C,35,CHI,12,0,114,21,41,0.512,0,0,0,21,41,0.512,0.512,4,7,0.571,14,18,32,4,2,7,3,15,46
2013,Darius Morris,PG,22,LAL,4,2,105,16,35,0.457,3,9,0.333,13,26,0.5,0.5,7,9,0.778,1,4,5,12,2,0,6,6,42
2013,Donatas Motiejunas,PF,22,HOU,1,0,5,2,2,1,0,0,0,2,2,1,1,1,1,1,1,0,1,0,0,0,0,0,5
2013,Steve Nash*,PG,38,LAL,2,2,61,10,23,0.435,0,3,0,10,20,0.5,0.435,5,5,1,2,3,5,9,0,0,3,2,25
2013,Gary Neal,SG,28,SAS,21,0,390,52,135,0.385,23,66,0.348,29,69,0.42,0.47,16,16,1,1,44,45,15,3,1,13,33,143
2013,Joakim Noah,C,27,CHI,12,12,409,52,119,0.437,0,0,0,52,119,0.437,0.437,25,39,0.641,52,63,115,28,10,26,24,43,129
2013,Steve Novak,SF,29,NYK,9,0,50,7,13,0.538,4,9,0.444,3,4,0.75,0.692,0,0,0,2,2,4,0,1,0,0,5,18
2013,Lamar Odom,PF,33,LAC,6,1,107,11,30,0.367,5,14,0.357,6,16,0.375,0.45,3,6,0.5,4,19,23,11,5,5,10,16,30
2013,Tony Parker,PG,30,SAS,21,21,765,167,365,0.458,11,31,0.355,156,334,0.467,0.473,87,112,0.777,14,54,68,146,24,3,53,26,432
2013,Chandler Parsons,SF,24,HOU,6,6,238,42,93,0.452,16,40,0.4,26,53,0.491,0.538,9,14,0.643,7,32,39,22,1,2,18,19,109
2013,Chris Paul,PG,27,LAC,6,6,224,49,92,0.533,6,19,0.316,43,73,0.589,0.565,33,37,0.892,3,21,24,38,11,0,9,17,137
2013,Kendrick Perkins,C,28,OKC,11,11,210,10,38,0.263,0,1,0,10,37,0.27,0.263,4,4,1,15,26,41,7,8,5,23,39,24
2013,Johan Petro,C,27,ATL,6,4,101,14,27,0.519,0,0,0,14,27,0.519,0.519,1,2,0.5,4,18,22,4,1,4,3,18,29
2013,Paul Pierce,SF,35,BOS,6,6,255,39,106,0.368,11,41,0.268,28,65,0.431,0.42,26,29,0.897,4,30,34,32,5,3,32,21,115
2013,Quincy Pondexter,SF,24,MEM,15,0,357,46,94,0.489,24,53,0.453,22,41,0.537,0.617,17,28,0.607,9,29,38,11,11,2,9,31,133
2013,Pablo Prigioni,PG,35,NYK,11,10,230,17,43,0.395,13,30,0.433,4,13,0.308,0.547,2,4,0.5,2,15,17,35,14,1,6,21,49
2013,Tayshaun Prince,SF,32,MEM,15,15,454,43,121,0.355,5,19,0.263,38,102,0.373,0.376,14,23,0.609,12,45,57,29,7,5,10,18,105
2013,Vladimir Radmanovic,PF,32,CHI,1,0,10,3,3,1,3,3,1,0,0,0,1.5,0,0,0,0,0,0,1,2,0,1,1,9
2013,Anthony Randolph,PF,23,DEN,5,0,30,9,11,0.818,0,0,0,9,11,0.818,0.818,8,11,0.727,0,6,6,0,2,0,2,4,26
2013,Shavlik Randolph,PF,29,BOS,1,0,3,0,0,,0,0,0,0,0,0,,0,0,0,0,3,3,0,0,0,0,1,0
2013,Zach Randolph,PF,31,MEM,15,15,554,99,215,0.46,0,1,0,99,214,0.463,0.46,63,94,0.67,59,91,150,24,10,7,31,52,261
2013,J.J. Redick,SG,28,MIL,4,0,69,11,25,0.44,4,12,0.333,7,13,0.538,0.52,3,3,1,0,3,3,5,1,0,6,9,29
2013,Quentin Richardson,SF,32,NYK,5,0,14,2,6,0.333,2,5,0.4,0,1,0,0.5,0,0,0,1,2,3,0,0,0,0,2,6
2013,Nate Robinson,PG,28,CHI,12,8,404,71,163,0.436,22,65,0.338,49,98,0.5,0.503,31,41,0.756,6,26,32,53,12,2,32,38,195
2013,Robert Sacre,C,23,LAL,2,0,4,0,1,0,0,0,0,0,1,0,0,0,0,0,0,2,2,0,1,0,0,0,0
2013,Larry Sanders,C,24,MIL,4,4,113,19,33,0.576,0,0,0,19,33,0.576,0.576,5,11,0.455,11,22,33,5,3,5,12,18,43
2013,Mike Scott,PF,24,ATL,4,0,20,5,10,0.5,0,1,0,5,9,0.556,0.5,3,4,0.75,1,6,7,1,0,0,0,2,13
2013,Thabo Sefolosha,SG,28,OKC,11,11,300,21,61,0.344,12,38,0.316,9,23,0.391,0.443,9,11,0.818,13,36,49,23,12,5,8,26,63
2013,Iman Shumpert,SG,22,NYK,12,12,337,41,100,0.41,18,42,0.429,23,58,0.397,0.5,12,14,0.857,18,54,72,16,13,3,14,36,112
2013,Greg Smith,C,22,HOU,5,1,59,6,9,0.667,0,0,0,6,9,0.667,0.667,6,12,0.5,7,6,13,0,2,2,4,9,18
2013,Ish Smith,PG,24,MIL,4,0,11,0,1,0,0,0,0,0,1,0,0,0,0,0,0,1,1,3,0,0,1,1,0
2013,J.R. Smith,SG,27,NYK,11,0,351,54,163,0.331,18,66,0.273,36,97,0.371,0.387,31,43,0.721,6,46,52,15,11,5,20,27,157
2013,Josh Smith,PF,27,ATL,6,6,199,39,90,0.433,5,20,0.25,34,70,0.486,0.461,19,36,0.528,10,35,45,21,11,3,16,21,102
2013,Tiago Splitter,PF,28,SAS,19,15,388,45,84,0.536,0,1,0,45,83,0.542,0.536,26,33,0.788,21,37,58,23,15,14,24,46,116
2013,Jerry Stackhouse,SF,38,BRK,4,0,28,1,10,0.1,0,7,0,1,3,0.333,0.1,3,4,0.75,1,3,4,0,0,0,2,2,5
2013,Lance Stephenson,SG,22,IND,19,19,673,69,169,0.408,18,64,0.281,51,105,0.486,0.462,23,37,0.622,14,130,144,63,23,2,36,47,179
2013,DeShawn Stevenson,SG,31,ATL,4,0,45,3,5,0.6,3,5,0.6,0,0,0,0.9,0,0,0,3,7,10,1,0,0,2,5,9
2013,Julyan Stone,PG,24,DEN,2,0,13,0,0,,0,0,0,0,0,0,,2,2,1,0,0,0,1,0,0,0,3,2
2013,Amar'e Stoudemire,PF,30,NYK,4,0,33,5,13,0.385,1,1,1,4,12,0.333,0.423,4,4,1,4,5,9,0,0,0,3,9,15
2013,Tyshawn Taylor,PG,22,BRK,2,0,2,0,1,0,0,0,0,0,1,0,0,0,0,0,0,0,0,0,0,0,0,0,0
2013,Jeff Teague,PG,24,ATL,6,6,213,27,81,0.333,3,10,0.3,24,71,0.338,0.352,23,28,0.821,3,14,17,30,9,2,14,17,80
2013,Marquis Teague,PG,19,CHI,8,0,72,5,17,0.294,0,5,0,5,12,0.417,0.294,0,0,0,0,3,3,12,2,1,2,10,10
2013,Mirza Teletovic,PF,27,BRK,1,0,1,0,0,,0,0,0,0,0,0,,0,0,0,0,0,0,0,0,0,0,0,0
2013,Jason Terry,SG,35,BOS,6,1,189,24,54,0.444,15,34,0.441,9,20,0.45,0.583,9,11,0.818,0,13,13,12,4,2,5,9,72
2013,Hasheem Thabeet,C,25,OKC,4,0,26,1,2,0.5,0,0,0,1,2,0.5,0.5,0,0,0,1,5,6,0,1,0,2,7,2
2013,Malcolm Thomas,PF,24,CHI,3,0,6,1,2,0.5,0,0,0,1,2,0.5,0.5,1,5,0.2,4,0,4,0,0,0,0,0,3
2013,Klay Thompson,SG,22,GSW,12,12,495,76,174,0.437,25,59,0.424,51,115,0.443,0.509,5,6,0.833,9,46,55,22,12,7,24,44,182
2013,Anthony Tolliver,SF,27,ATL,6,0,68,8,14,0.571,7,11,0.636,1,3,0.333,0.821,1,3,0.333,3,6,9,1,1,1,1,7,24
2013,Ronny Turiaf,C,30,LAC,5,0,59,7,10,0.7,0,0,0,7,10,0.7,0.7,2,4,0.5,4,4,8,0,1,3,2,14,16
2013,Ekpe Udoh,C,25,MIL,4,0,54,4,9,0.444,0,0,0,4,9,0.444,0.444,0,0,0,3,3,6,1,2,2,0,4,8
2013,Dwyane Wade,SG,31,MIA,22,22,782,144,315,0.457,1,4,0.25,143,311,0.46,0.459,60,80,0.75,38,64,102,105,38,23,58,45,349
2013,Gerald Wallace,SF,30,BRK,7,7,243,31,67,0.463,11,29,0.379,20,38,0.526,0.545,11,20,0.55,5,23,28,17,8,5,9,20,84
2013,C.J. Watson,PG,28,BRK,7,0,161,24,55,0.436,4,15,0.267,20,40,0.5,0.473,8,12,0.667,5,12,17,13,5,1,1,11,60
2013,David West,PF,32,IND,19,19,689,115,249,0.462,0,3,0,115,246,0.467,0.462,72,94,0.766,41,103,144,39,13,15,45,54,302
2013,Russell Westbrook,PG,24,OKC,2,2,68,17,41,0.415,2,9,0.222,15,32,0.469,0.439,12,14,0.857,1,12,13,14,6,0,8,5,48
2013,James White,SF,30,NYK,4,0,9,2,4,0.5,0,2,0,2,2,1,0.5,0,0,0,1,1,2,0,0,0,0,1,4
2013,Chris Wilcox,C,30,BOS,2,0,6,0,0,,0,0,0,0,0,0,,0,0,0,0,2,2,0,0,0,0,0,0
2013,Deron Williams,PG,28,BRK,7,7,292,45,106,0.425,17,43,0.395,28,63,0.444,0.505,37,45,0.822,1,21,22,59,7,4,21,17,144
2013,Terrence Williams,SF,25,BOS,5,0,48,2,10,0.2,0,3,0,2,7,0.286,0.2,1,2,0.5,1,9,10,6,0,1,4,3,5
2013,Metta World Peace,SF,33,LAL,3,3,84,7,28,0.25,2,14,0.143,5,14,0.357,0.286,2,2,1,6,5,11,5,2,1,3,5,18
2013,Tony Wroten,SG,19,MEM,6,0,17,2,11,0.182,0,2,0,2,9,0.222,0.182,4,4,1,1,3,4,2,1,0,2,1,8
2013,Sam Young,SG,27,IND,15,0,130,9,24,0.375,2,10,0.2,7,14,0.5,0.417,6,8,0.75,11,18,29,4,4,1,7,17,26
2014,Steven Adams,C,20,OKC,18,0,331,31,45,0.689,0,0,0,31,45,0.689,0.689,8,23,0.348,22,52,74,4,1,24,10,48,70
2014,LaMarcus Aldridge,PF,28,POR,11,11,441,113,250,0.452,2,3,0.667,111,247,0.449,0.456,60,75,0.8,30,87,117,16,7,18,19,40,288
2014,Lavoy Allen,PF,24,IND,4,0,15,2,4,0.5,0,0,0,2,4,0.5,0.5,0,0,0,1,4,5,1,0,0,0,1,4
2014,Ray Allen*,SG,38,MIA,20,1,527,59,143,0.413,33,85,0.388,26,58,0.448,0.528,34,37,0.919,13,54,67,32,14,4,24,41,185
2014,Tony Allen,SG,32,MEM,7,1,230,35,72,0.486,0,7,0,35,65,0.538,0.486,16,21,0.762,23,31,54,10,12,1,12,23,86
2014,Chris Andersen,C,35,MIA,18,0,317,33,57,0.579,0,1,0,33,56,0.589,0.579,26,38,0.684,26,81,107,5,5,18,9,34,92
2014,Alan Anderson,SF,31,BRK,12,2,261,25,62,0.403,9,31,0.29,16,31,0.516,0.476,12,18,0.667,10,22,32,15,10,0,10,32,71
2014,Pero Antic,C,31,ATL,7,7,170,7,42,0.167,3,25,0.12,4,17,0.235,0.202,5,8,0.625,10,17,27,5,5,3,8,26,22
2014,Trevor Ariza,SF,28,WAS,11,11,407,52,108,0.481,25,56,0.446,27,52,0.519,0.597,21,27,0.778,21,77,98,19,17,4,14,26,150
2014,Hilton Armstrong,C,29,GSW,7,0,17,4,8,0.5,0,1,0,4,7,0.571,0.5,0,2,0,3,1,4,2,0,2,4,6,8
2014,Omer Asik,C,27,HOU,6,4,163,16,33,0.485,0,0,0,16,33,0.485,0.485,3,3,1,21,28,49,4,3,4,11,29,35
2014,D.J. Augustin,PG,26,CHI,5,0,141,21,72,0.292,7,26,0.269,14,46,0.304,0.34,17,19,0.895,4,4,8,24,3,0,9,16,66
2014,Jeff Ayres,PF,26,SAS,17,0,65,6,13,0.462,0,0,0,6,13,0.462,0.462,5,8,0.625,6,13,19,5,0,0,1,6,17
2014,Harrison Barnes,SF,21,GSW,7,0,156,19,48,0.396,8,21,0.381,11,27,0.407,0.479,9,16,0.563,7,21,28,8,1,3,5,13,55
2014,Matt Barnes,SF,33,LAC,13,13,404,45,107,0.421,19,60,0.317,26,47,0.553,0.509,13,19,0.684,22,36,58,23,12,3,17,41,122
2014,Will Barton,SG,23,POR,7,0,81,17,34,0.5,6,11,0.545,11,23,0.478,0.588,5,6,0.833,5,7,12,3,1,2,6,7,45
2014,Shane Battier,SF,35,MIA,16,6,202,12,26,0.462,9,20,0.45,3,6,0.5,0.635,4,5,0.8,1,9,10,5,5,1,5,23,37
2014,Nicolas Batum,SF,25,POR,11,11,459,67,142,0.472,21,60,0.35,46,82,0.561,0.546,12,15,0.8,10,74,84,53,14,5,28,21,167
2014,Aron Baynes,C,27,SAS,14,0,101,12,24,0.5,0,1,0,12,23,0.522,0.5,8,10,0.8,12,19,31,0,3,0,7,15,32
2014,Bradley Beal,SG,20,WAS,11,11,458,75,177,0.424,22,53,0.415,53,124,0.427,0.486,39,49,0.796,15,40,55,50,18,7,23,31,211
2014,Michael Beasley,SF,25,MIA,4,0,23,5,10,0.5,0,0,0,5,10,0.5,0.5,1,3,0.333,2,2,4,2,0,0,1,3,11
2014,Marco Belinelli,SF,27,SAS,23,0,356,44,99,0.444,16,38,0.421,28,61,0.459,0.525,21,22,0.955,4,48,52,19,3,0,12,23,125
2014,Patrick Beverley,PG,25,HOU,6,6,202,19,50,0.38,7,22,0.318,12,28,0.429,0.45,7,10,0.7,13,12,25,11,3,2,4,21,52
2014,Bismack Biyombo,C,21,CHA,3,1,48,3,5,0.6,0,0,0,3,5,0.6,0.6,2,6,0.333,5,6,11,1,0,2,0,4,8
2014,DeJuan Blair,PF,24,DAL,6,0,81,16,27,0.593,0,0,0,16,27,0.593,0.593,8,13,0.615,14,23,37,1,12,0,5,14,40
2014,Steve Blake,PG,33,GSW,6,0,45,4,12,0.333,3,10,0.3,1,2,0.5,0.458,0,1,0,1,3,4,2,0,0,2,2,11
2014,Andray Blatche,PF,27,BRK,12,0,172,26,58,0.448,0,2,0,26,56,0.464,0.448,25,30,0.833,25,35,60,4,6,2,10,22,77
2014,Matt Bonner,PF,33,SAS,22,2,136,10,21,0.476,4,12,0.333,6,9,0.667,0.571,3,4,0.75,2,12,14,11,2,1,2,12,27
2014,Trevor Booker,PF,26,WAS,9,1,146,13,29,0.448,0,2,0,13,27,0.481,0.448,4,6,0.667,16,23,39,8,2,9,3,25,30
2014,Carlos Boozer,PF,32,CHI,5,5,121,20,47,0.426,0,0,0,20,47,0.426,0.426,8,9,0.889,8,31,39,5,1,0,7,13,48
2014,Chris Bosh,C,29,MIA,20,20,686,116,229,0.507,30,74,0.405,86,155,0.555,0.572,36,48,0.75,24,88,112,21,17,20,14,51,298
2014,Elton Brand,C,34,ATL,7,0,81,2,12,0.167,0,0,0,2,12,0.167,0.167,4,5,0.8,7,16,23,6,1,6,0,10,8
2014,Reggie Bullock,SF,22,LAC,2,0,5,1,1,1,0,0,0,1,1,1,1,0,0,0,0,0,0,1,0,0,0,0,2
2014,Caron Butler,SF,33,OKC,18,2,419,35,108,0.324,21,59,0.356,14,49,0.286,0.421,22,28,0.786,11,47,58,15,5,2,11,33,113
2014,Jimmy Butler,SG,24,CHI,5,5,218,22,57,0.386,6,20,0.3,16,37,0.432,0.439,18,23,0.783,6,20,26,11,6,0,3,13,68
2014,Rasual Butler,SG,34,IND,11,0,70,6,15,0.4,5,12,0.417,1,3,0.333,0.567,2,2,1,0,6,6,1,1,1,1,3,19
2014,Jose Calderon,PG,32,DAL,7,7,191,30,65,0.462,11,23,0.478,19,42,0.452,0.546,1,1,1,2,7,9,31,1,0,7,16,72
2014,DeMarre Carroll,SF,27,ATL,7,7,246,23,49,0.469,9,22,0.409,14,27,0.519,0.561,7,11,0.636,12,22,34,11,5,3,8,21,62
2014,Vince Carter,SG,37,DAL,7,0,190,31,68,0.456,15,31,0.484,16,37,0.432,0.566,11,14,0.786,7,18,25,17,3,2,6,12,88
2014,Mario Chalmers,PG,27,MIA,20,19,535,47,111,0.423,15,43,0.349,32,68,0.471,0.491,19,25,0.76,2,44,46,72,19,6,30,48,128
2014,Victor Claver,SF,25,POR,2,0,7,0,0,,0,0,0,0,0,0,,0,4,0,0,5,5,0,0,0,1,0,0
2014,Norris Cole,PG,25,MIA,20,0,404,32,78,0.41,15,40,0.375,17,38,0.447,0.506,13,15,0.867,1,21,22,36,9,1,19,34,92
2014,Darren Collison,PG,26,LAC,13,0,249,35,90,0.389,1,12,0.083,34,78,0.436,0.394,39,45,0.867,10,17,27,31,6,1,12,17,110
2014,Nick Collison,PF,33,OKC,17,2,183,12,29,0.414,2,5,0.4,10,24,0.417,0.448,7,10,0.7,12,26,38,13,4,7,6,28,33
2014,Mike Conley,PG,26,MEM,7,7,267,44,102,0.431,3,27,0.111,41,75,0.547,0.446,20,26,0.769,5,27,32,55,14,1,15,14,111
2014,Chris Copeland,SF,29,IND,12,0,82,12,28,0.429,6,16,0.375,6,12,0.5,0.536,6,9,0.667,1,4,5,1,3,3,5,13,36
2014,Jamal Crawford,SG,33,LAC,13,0,313,68,171,0.398,27,79,0.342,41,92,0.446,0.477,39,44,0.886,5,14,19,26,12,2,15,24,202
2014,Jordan Crawford,SG,25,GSW,6,0,57,12,33,0.364,2,7,0.286,10,26,0.385,0.394,11,14,0.786,4,5,9,2,1,0,5,7,37
2014,Jae Crowder,SF,23,DAL,7,0,81,8,18,0.444,3,7,0.429,5,11,0.455,0.528,0,0,0,4,8,12,2,2,1,3,13,19
2014,Stephen Curry,PG,25,GSW,7,7,296,51,116,0.44,22,57,0.386,29,59,0.492,0.534,37,42,0.881,4,21,25,59,12,1,26,18,161
2014,Samuel Dalembert,C,32,DAL,7,7,135,11,24,0.458,0,0,0,11,24,0.458,0.458,10,15,0.667,23,36,59,0,2,10,4,15,32
2014,Troy Daniels,SG,22,HOU,4,0,68,9,17,0.529,8,15,0.533,1,2,0.5,0.765,5,5,1,3,6,9,1,2,0,2,10,31
2014,Ed Davis,PF,24,MEM,7,0,25,3,10,0.3,0,0,0,3,10,0.3,0.3,0,1,0,8,7,15,0,1,3,2,2,6
2014,Glen Davis,PF,28,LAC,13,0,158,25,41,0.61,0,0,0,25,41,0.61,0.61,0,0,0,14,22,36,9,3,3,7,24,50
2014,Austin Daye,SF,25,SAS,1,0,6,0,2,0,0,0,0,0,2,0,0,0,0,0,0,1,1,0,0,0,0,0,0
2014,Nando De Colo,SF,26,TOR,1,0,4,0,0,,0,0,0,0,0,0,,0,0,0,0,1,1,0,0,0,0,2,0
2014,DeMar DeRozan,SG,24,TOR,7,7,282,45,117,0.385,6,18,0.333,39,99,0.394,0.41,71,79,0.899,3,26,29,25,8,2,18,23,167
2014,Boris Diaw,PF,31,SAS,23,3,604,80,160,0.5,18,45,0.4,62,115,0.539,0.556,33,48,0.688,25,86,111,78,14,3,29,44,211
2014,Toney Douglas,PG,27,MIA,10,0,29,3,9,0.333,3,6,0.5,0,3,0,0.5,1,2,0.5,1,3,4,5,0,0,1,3,10
2014,Chris Douglas-Roberts,SF,27,CHA,4,0,70,11,16,0.688,4,8,0.5,7,8,0.875,0.813,12,14,0.857,2,6,8,2,0,0,4,11,38
2014,Jared Dudley,SF,28,LAC,7,0,45,3,11,0.273,3,6,0.5,0,5,0,0.409,0,0,0,0,6,6,2,1,0,0,5,9
2014,Tim Duncan,C,37,SAS,23,23,752,149,285,0.523,0,2,0,149,283,0.527,0.523,76,100,0.76,65,146,211,45,7,29,26,52,374
2014,Mike Dunleavy,SF,33,CHI,5,5,163,25,53,0.472,12,26,0.462,13,27,0.481,0.585,4,6,0.667,5,13,18,12,3,1,5,7,66
2014,Kevin Durant,SF,25,OKC,19,19,815,194,422,0.46,43,125,0.344,151,297,0.508,0.511,132,163,0.81,25,145,170,75,19,25,72,41,563
2014,Wayne Ellington,SG,26,DAL,2,0,14,2,6,0.333,2,6,0.333,0,0,0,0.5,2,2,1,0,2,2,2,0,0,2,1,8
2014,Monta Ellis,SG,28,DAL,7,7,249,52,127,0.409,12,34,0.353,40,93,0.43,0.457,27,31,0.871,6,11,17,20,9,1,15,19,143
2014,Landry Fields,SF,25,TOR,3,0,26,0,2,0,0,0,0,0,2,0,0,0,0,0,2,5,7,1,4,1,1,2,0
2014,Derek Fisher,SG,39,OKC,19,0,299,23,73,0.315,12,41,0.293,11,32,0.344,0.397,15,15,1,6,27,33,16,13,0,6,27,73
2014,Jamaal Franklin,SG,22,MEM,2,0,4,0,2,0,0,0,0,0,2,0,0,1,2,0.5,0,1,1,0,0,0,0,0,1
2014,Joel Freeland,C,26,POR,9,0,24,0,3,0,0,0,0,0,3,0,0,1,2,0.5,4,4,8,1,1,1,4,7,1
2014,Francisco Garcia,SF,32,HOU,2,0,22,2,6,0.333,0,3,0,2,3,0.667,0.333,3,4,0.75,1,1,2,0,0,0,0,3,7
2014,Kevin Garnett,C,37,BRK,12,12,250,33,63,0.524,0,2,0,33,61,0.541,0.524,17,23,0.739,19,57,76,16,9,5,13,25,83
2014,Marc Gasol,C,29,MEM,7,7,299,47,116,0.405,0,1,0,47,115,0.409,0.405,27,34,0.794,13,41,54,31,12,6,12,27,121
2014,Paul George,SF,23,IND,19,19,781,138,315,0.438,52,129,0.403,86,186,0.462,0.521,101,128,0.789,13,132,145,73,41,7,49,56,429
2014,Taj Gibson,PF,28,CHI,5,0,154,32,57,0.561,0,0,0,32,57,0.561,0.561,27,36,0.75,21,10,31,2,2,12,8,12,91
2014,Manu Ginobili,SG,36,SAS,23,0,586,104,237,0.439,41,105,0.39,63,132,0.477,0.525,81,94,0.862,9,66,75,95,36,2,52,60,330
2014,Drew Gooden,C,32,WAS,10,0,146,14,38,0.368,0,4,0,14,34,0.412,0.368,6,8,0.75,20,22,42,4,3,4,4,30,34
2014,Marcin Gortat,C,29,WAS,11,11,382,58,118,0.492,0,0,0,58,118,0.492,0.492,27,41,0.659,36,73,109,16,5,14,20,22,143
2014,Danny Granger,SF,30,LAC,13,0,134,11,40,0.275,5,22,0.227,6,18,0.333,0.338,7,9,0.778,2,18,20,3,6,1,3,24,34
2014,Danny Green,SG,26,SAS,23,23,529,78,159,0.491,48,101,0.475,30,58,0.517,0.642,9,11,0.818,9,60,69,21,32,17,20,50,213
2014,Draymond Green,SF,23,GSW,7,4,228,28,60,0.467,8,29,0.276,20,31,0.645,0.533,19,24,0.792,18,40,58,20,12,12,17,33,83
2014,Willie Green,SG,32,LAC,5,0,19,1,5,0.2,1,4,0.25,0,1,0,0.3,2,2,1,0,7,7,1,3,0,1,3,5
2014,Blake Griffin,PF,24,LAC,13,13,478,117,234,0.5,1,7,0.143,116,227,0.511,0.502,71,96,0.74,35,61,96,50,16,14,31,54,306
2014,Jorge Gutierrez,PG,25,BRK,2,0,3,0,0,,0,0,0,0,0,0,,2,4,0.5,1,0,1,0,0,0,0,0,2
2014,Tyler Hansbrough,PF,28,TOR,3,0,29,1,3,0.333,0,0,0,1,3,0.333,0.333,5,6,0.833,2,4,6,1,0,0,2,8,7
2014,James Harden,SG,24,HOU,6,6,263,50,133,0.376,16,54,0.296,34,79,0.43,0.436,45,50,0.9,5,23,28,35,12,1,21,21,161
2014,Al Harrington,PF,33,WAS,7,0,59,6,15,0.4,0,7,0,6,8,0.75,0.4,5,7,0.714,1,15,16,0,3,0,4,14,17
2014,Devin Harris,PG,30,DAL,7,0,176,31,66,0.47,11,25,0.44,20,41,0.488,0.553,7,8,0.875,1,16,17,27,2,2,11,13,80
2014,Udonis Haslem,PF,33,MIA,16,6,169,17,37,0.459,0,0,0,17,37,0.459,0.459,6,10,0.6,12,29,41,4,1,3,1,28,40
2014,Chuck Hayes,C,30,TOR,5,0,38,2,8,0.25,0,0,0,2,8,0.25,0.25,2,2,1,4,4,8,2,3,0,1,5,6
2014,Gerald Henderson,SG,26,CHA,4,4,119,14,37,0.378,0,9,0,14,28,0.5,0.378,11,17,0.647,1,15,16,9,4,1,6,12,39
2014,Roy Hibbert,C,27,IND,19,19,542,66,147,0.449,0,1,0,66,146,0.452,0.449,44,57,0.772,44,61,105,17,4,26,25,62,176
2014,Nene Hilario,PF,31,WAS,10,10,325,64,138,0.464,0,0,0,64,138,0.464,0.464,9,26,0.346,8,45,53,26,9,11,17,36,137
2014,George Hill,PG,27,IND,19,19,687,79,178,0.444,28,77,0.364,51,101,0.505,0.522,44,61,0.721,13,58,71,57,23,4,28,43,230
2014,Solomon Hill,SF,22,IND,1,0,1,0,0,,0,0,0,0,0,0,,0,0,0,0,0,0,0,0,0,0,0,0
2014,Kirk Hinrich,PG,33,CHI,5,5,167,23,56,0.411,7,19,0.368,16,37,0.432,0.473,2,4,0.5,1,14,15,22,4,1,11,22,55
2014,Ryan Hollins,PF,29,LAC,5,0,9,1,4,0.25,0,0,0,1,4,0.25,0.25,1,1,1,1,2,3,0,0,0,1,3,3
2014,Dwight Howard,C,28,HOU,6,6,231,58,106,0.547,0,0,0,58,106,0.547,0.547,40,64,0.625,27,55,82,11,4,17,19,25,156
2014,Serge Ibaka,PF,24,OKC,17,17,581,87,147,0.592,5,13,0.385,82,134,0.612,0.609,26,34,0.765,31,85,116,12,11,42,20,54,205
2014,Andre Iguodala,SF,30,GSW,7,7,248,32,62,0.516,8,15,0.533,24,47,0.511,0.581,20,33,0.606,5,28,33,31,9,2,21,19,92
2014,Reggie Jackson,PG,23,OKC,19,4,531,75,161,0.466,21,53,0.396,54,108,0.5,0.531,39,44,0.886,13,59,72,46,5,4,38,49,210
2014,Bernard James,C,28,DAL,2,0,8,0,0,,0,0,0,0,0,0,,0,0,0,1,0,1,0,1,0,0,0,0
2014,LeBron James,PF,29,MIA,20,20,763,192,340,0.565,35,86,0.407,157,254,0.618,0.616,129,160,0.806,14,127,141,95,36,11,61,46,548
2014,Al Jefferson,C,29,CHA,3,3,106,26,53,0.491,0,0,0,26,53,0.491,0.491,4,5,0.8,6,22,28,2,1,5,1,7,56
2014,Amir Johnson,PF,26,TOR,7,7,191,34,52,0.654,0,2,0,34,50,0.68,0.654,9,12,0.75,16,26,42,7,3,4,12,29,77
2014,James Johnson,SF,26,MEM,3,0,28,5,15,0.333,2,5,0.4,3,10,0.3,0.4,7,10,0.7,4,2,6,0,1,0,0,3,19
2014,Joe Johnson,SG,32,BRK,12,12,469,98,184,0.533,22,53,0.415,76,131,0.58,0.592,36,43,0.837,9,37,46,35,6,3,19,20,254
2014,James Jones,SF,33,MIA,15,0,126,18,40,0.45,15,32,0.469,3,8,0.375,0.638,2,3,0.667,3,8,11,5,3,2,0,17,53
2014,Perry Jones,PF,22,OKC,11,0,55,7,18,0.389,3,10,0.3,4,8,0.5,0.472,0,0,0,3,6,9,1,0,1,1,9,17
2014,Terrence Jones,PF,22,HOU,6,2,138,20,39,0.513,0,1,0,20,38,0.526,0.513,6,12,0.5,17,20,37,8,5,3,2,13,46
2014,DeAndre Jordan,C,25,LAC,13,13,442,46,63,0.73,0,0,0,46,63,0.73,0.73,33,76,0.434,43,120,163,10,12,33,23,45,125
2014,Cory Joseph,SG,22,SAS,17,0,87,17,35,0.486,0,3,0,17,32,0.531,0.486,14,18,0.778,1,8,9,9,3,0,4,7,48
2014,Michael Kidd-Gilchrist,SF,20,CHA,4,4,91,14,27,0.519,0,1,0,14,26,0.538,0.519,6,10,0.6,8,18,26,6,0,2,8,13,34
2014,Andrei Kirilenko,PF,32,BRK,10,0,144,7,15,0.467,0,0,0,7,15,0.467,0.467,11,17,0.647,10,13,23,10,10,3,3,11,25
2014,Kyle Korver,SG,32,ATL,7,7,250,30,66,0.455,23,54,0.426,7,12,0.583,0.629,11,12,0.917,2,35,37,5,4,2,11,15,94
2014,Kosta Koufos,C,24,MEM,7,0,45,7,16,0.438,0,0,0,7,16,0.438,0.438,4,4,1,7,8,15,2,2,3,3,7,18
2014,Ognjen Kuzmic,C,23,GSW,3,0,8,0,0,,0,0,0,0,0,0,,0,0,0,1,3,4,0,0,0,0,2,0
2014,Jeremy Lamb,SG,21,OKC,11,0,100,17,42,0.405,2,14,0.143,15,28,0.536,0.429,4,4,1,4,12,16,7,7,1,3,8,40
2014,Shane Larkin,PG,21,DAL,2,0,10,0,3,0,0,1,0,0,2,0,0,0,0,0,0,1,1,2,0,0,1,0,0
2014,Courtney Lee,SG,28,MEM,7,7,224,25,60,0.417,6,19,0.316,19,41,0.463,0.467,14,18,0.778,3,11,14,11,5,2,6,20,70
2014,David Lee,PF,30,GSW,7,7,217,41,77,0.532,0,0,0,41,77,0.532,0.532,15,19,0.789,24,40,64,18,4,0,17,28,97
2014,Kawhi Leonard,SF,22,SAS,23,23,736,122,239,0.51,31,74,0.419,91,165,0.552,0.575,53,72,0.736,31,124,155,38,39,14,29,66,328
2014,Meyers Leonard,C,21,POR,4,0,9,0,2,0,0,0,0,0,2,0,0,0,0,0,0,2,2,0,0,0,0,1,0
2014,Jon Leuer,PF,24,MEM,3,0,23,3,7,0.429,1,2,0.5,2,5,0.4,0.5,2,2,1,2,6,8,2,1,0,0,2,9
2014,Rashard Lewis,SF,34,MIA,18,8,319,35,85,0.412,22,59,0.373,13,26,0.5,0.541,3,4,0.75,4,33,37,5,7,6,5,29,95
2014,Damian Lillard,PG,23,POR,11,11,466,83,189,0.439,27,70,0.386,56,119,0.471,0.511,59,66,0.894,12,44,56,72,11,1,30,29,252
2014,Jeremy Lin,PG,25,HOU,6,0,177,25,61,0.41,5,23,0.217,20,38,0.526,0.451,13,16,0.813,7,15,22,26,3,1,13,15,68
2014,Shaun Livingston,PG,28,BRK,12,10,325,44,86,0.512,1,1,1,43,85,0.506,0.517,27,37,0.73,8,34,42,40,5,5,22,41,116
2014,Robin Lopez,C,25,POR,11,11,367,43,88,0.489,0,0,0,43,88,0.489,0.489,24,36,0.667,47,54,101,9,6,20,11,40,110
2014,Kyle Lowry,PG,27,TOR,7,7,271,44,109,0.404,17,43,0.395,27,66,0.409,0.482,43,49,0.878,9,24,33,33,6,0,20,27,148
2014,Shelvin Mack,PG,23,ATL,7,0,118,19,47,0.404,10,27,0.37,9,20,0.45,0.511,9,12,0.75,3,10,13,25,4,0,6,10,57
2014,Ian Mahinmi,C,27,IND,19,0,241,13,27,0.481,0,0,0,13,27,0.481,0.481,11,18,0.611,22,23,45,3,5,16,10,38,37
2014,Shawn Marion,SF,35,DAL,7,7,193,24,59,0.407,4,18,0.222,20,41,0.488,0.441,7,11,0.636,14,23,37,13,6,1,5,11,59
2014,Cartier Martin,SF,29,ATL,3,0,15,2,3,0.667,0,0,0,2,3,0.667,0.667,0,0,0,1,2,3,0,2,0,1,2,4
2014,Wesley Matthews,SG,27,POR,11,11,426,56,136,0.412,22,68,0.324,34,68,0.5,0.493,26,32,0.813,7,36,43,14,14,5,22,45,160
2014,CJ McCollum,SG,22,POR,6,0,24,1,11,0.091,0,5,0,1,6,0.167,0.091,2,2,1,0,1,1,0,0,0,1,2,4
2014,Josh McRoberts,PF,26,CHA,4,4,154,15,33,0.455,8,17,0.471,7,16,0.438,0.576,8,10,0.8,1,26,27,15,4,1,6,13,46
2014,Andre Miller,SG,37,WAS,11,0,108,19,41,0.463,1,3,0.333,18,38,0.474,0.476,5,9,0.556,2,9,11,9,3,0,8,12,44
2014,Mike Miller,SF,33,MEM,7,1,173,15,42,0.357,14,29,0.483,1,13,0.077,0.524,7,9,0.778,2,24,26,9,6,0,5,16,51
2014,Patty Mills,PG,25,SAS,23,0,351,63,141,0.447,32,79,0.405,31,62,0.5,0.56,10,13,0.769,3,32,35,33,17,1,14,31,168
2014,Paul Millsap,PF,28,ATL,7,7,267,41,103,0.398,9,27,0.333,32,76,0.421,0.442,45,56,0.804,21,55,76,20,10,13,20,25,136
2014,Nazr Mohammed,C,36,CHI,2,0,5,0,1,0,0,0,0,0,1,0,0,0,0,0,1,1,2,0,0,0,0,3,0
2014,Mike Muscala,PF,22,ATL,2,0,5,0,2,0,0,0,0,0,2,0,0,0,0,0,0,0,0,0,0,0,0,0,0
2014,Gary Neal,SG,29,CHA,4,0,104,18,51,0.353,4,18,0.222,14,33,0.424,0.392,5,7,0.714,3,5,8,4,0,0,8,9,45
2014,Nemanja Nedovic,SG,22,GSW,1,0,0,0,0,,0,0,0,0,0,0,,0,0,0,0,0,0,0,0,0,0,1,0
2014,Joakim Noah,C,28,CHI,5,5,210,21,41,0.512,0,0,0,21,41,0.512,0.512,10,17,0.588,15,49,64,23,5,7,19,19,52
2014,Steve Novak,PF,30,TOR,4,0,15,0,3,0,0,3,0,0,0,0,0,0,0,0,0,5,5,1,0,0,0,0,0
2014,Dirk Nowitzki,PF,35,DAL,7,7,263,54,126,0.429,1,12,0.083,53,114,0.465,0.433,25,31,0.806,5,51,56,11,6,6,15,20,134
2014,Jermaine O'Neal,PF,35,GSW,7,3,84,18,32,0.563,0,0,0,18,32,0.563,0.563,6,8,0.75,12,12,24,1,1,3,4,12,42
2014,Greg Oden,C,26,MIA,3,0,7,0,0,,0,0,0,0,0,0,,0,0,0,0,1,1,1,1,0,0,2,0
2014,Jannero Pargo,PG,34,CHA,1,0,3,0,0,,0,0,0,0,0,0,,0,0,0,0,1,1,1,0,0,1,0,0
2014,Tony Parker,PG,31,SAS,23,23,719,168,346,0.486,13,35,0.371,155,311,0.498,0.504,51,70,0.729,5,40,45,111,15,2,62,37,400
2014,Chandler Parsons,SF,25,HOU,6,6,250,46,105,0.438,13,36,0.361,33,69,0.478,0.5,11,15,0.733,6,35,41,14,4,2,5,19,116
2014,Patrick Patterson,PF,24,TOR,7,0,199,26,48,0.542,7,18,0.389,19,30,0.633,0.615,14,18,0.778,12,35,47,9,3,3,6,13,73
2014,Chris Paul,PG,28,LAC,13,13,472,92,197,0.467,32,70,0.457,60,127,0.472,0.548,41,53,0.774,12,43,55,134,37,0,39,50,257
2014,Kendrick Perkins,C,29,OKC,19,19,384,24,45,0.533,0,0,0,24,45,0.533,0.533,12,15,0.8,33,69,102,14,4,6,25,64,60
2014,Paul Pierce,SF,36,BRK,12,12,368,60,129,0.465,19,53,0.358,41,76,0.539,0.539,25,32,0.781,4,50,54,24,14,4,20,44,164
2014,Mason Plumlee,C,23,BRK,10,0,114,7,16,0.438,0,0,0,7,16,0.438,0.438,8,18,0.444,5,18,23,2,3,7,9,24,22
2014,Otto Porter,SF,20,WAS,3,0,6,1,3,0.333,0,1,0,1,2,0.5,0.333,0,0,0,0,0,0,0,0,0,0,0,2
2014,Tayshaun Prince,SF,33,MEM,7,6,113,10,26,0.385,1,4,0.25,9,22,0.409,0.404,0,0,0,4,6,10,6,1,0,1,8,21
2014,Zach Randolph,PF,32,MEM,6,6,234,42,104,0.404,0,1,0,42,103,0.408,0.404,25,41,0.61,17,35,52,14,5,1,10,13,109
2014,J.J. Redick,SG,29,LAC,13,13,351,61,133,0.459,26,65,0.4,35,68,0.515,0.556,25,26,0.962,4,18,22,19,11,0,13,23,173
2014,Luke Ridnour,PG,32,CHA,4,0,36,4,13,0.308,2,6,0.333,2,7,0.286,0.385,0,0,0,0,4,4,12,0,1,4,1,10
2014,Andre Roberson,SG,22,OKC,2,0,9,0,3,0,0,0,0,0,3,0,0,0,0,0,0,2,2,0,0,0,0,0,0
2014,Thomas Robinson,PF,22,POR,11,0,122,13,31,0.419,0,0,0,13,31,0.419,0.419,6,7,0.857,10,18,28,6,5,5,5,23,32
2014,Terrence Ross,SG,22,TOR,7,7,158,14,47,0.298,4,24,0.167,10,23,0.435,0.34,3,5,0.6,1,13,14,2,6,3,8,19,35
2014,John Salmons,SG,34,TOR,6,0,77,5,17,0.294,2,12,0.167,3,5,0.6,0.353,1,1,1,0,6,6,5,2,0,1,9,13
2014,Dennis Schroder,PG,20,ATL,2,0,7,2,2,1,1,1,1,1,1,1,1.25,0,0,0,0,2,2,0,0,0,0,1,5
2014,Luis Scola,PF,33,IND,18,0,243,48,105,0.457,1,3,0.333,47,102,0.461,0.462,13,22,0.591,11,31,42,9,6,3,7,29,110
2014,Mike Scott,PF,25,ATL,7,0,146,23,63,0.365,10,31,0.323,13,32,0.406,0.444,10,14,0.714,3,15,18,3,1,0,2,11,66
2014,Thabo Sefolosha,SG,29,OKC,15,13,236,23,55,0.418,6,23,0.261,17,32,0.531,0.473,4,5,0.8,7,24,31,10,10,0,7,10,56
2014,Kevin Seraphin,C,24,WAS,4,0,6,0,3,0,0,0,0,0,3,0,0,0,0,0,1,1,2,0,0,0,1,1,0
2014,Donald Sloan,SG,26,IND,4,0,15,2,7,0.286,1,4,0.25,1,3,0.333,0.357,2,4,0.5,0,1,1,3,1,0,2,0,7
2014,Tony Snell,SG,22,CHI,5,0,46,2,9,0.222,0,5,0,2,4,0.5,0.222,0,0,0,0,6,6,2,1,1,1,5,4
2014,Marreese Speights,C,26,GSW,7,0,68,19,36,0.528,0,0,0,19,36,0.528,0.528,6,12,0.5,9,13,22,3,2,4,2,12,44
2014,Tiago Splitter,C,29,SAS,23,18,516,61,100,0.61,0,1,0,61,99,0.616,0.61,51,71,0.718,45,95,140,46,16,11,18,53,173
2014,Lance Stephenson,SG,23,IND,19,19,705,100,220,0.455,24,67,0.358,76,153,0.497,0.509,35,49,0.714,24,107,131,80,16,4,46,55,259
2014,Jeff Teague,PG,25,ATL,7,7,242,44,112,0.393,9,27,0.333,35,85,0.412,0.433,38,40,0.95,5,21,26,35,7,4,21,15,135
2014,Mirza Teletovic,SF,28,BRK,12,0,220,36,82,0.439,19,56,0.339,17,26,0.654,0.555,8,12,0.667,15,25,40,3,5,2,5,14,99
2014,Garrett Temple,SG,27,WAS,10,0,9,2,2,1,1,1,1,1,1,1,1.25,0,0,0,0,0,0,0,0,0,1,5,5
2014,Hasheem Thabeet,C,26,OKC,2,0,7,0,0,,0,0,0,0,0,0,,0,0,0,0,0,0,0,0,0,0,4,0
2014,Klay Thompson,SG,23,GSW,7,7,257,40,98,0.408,16,44,0.364,24,54,0.444,0.49,19,24,0.792,4,20,24,25,7,5,15,24,115
2014,Marcus Thornton,SG,26,BRK,10,0,124,21,54,0.389,5,21,0.238,16,33,0.485,0.435,12,18,0.667,7,12,19,1,2,1,2,4,59
2014,Anthony Tolliver,PF,28,CHA,4,0,21,1,2,0.5,1,2,0.5,0,0,0,0.75,3,3,1,1,3,4,1,0,0,0,2,6
2014,Hedo Turkoglu,SF,34,LAC,5,0,41,6,13,0.462,4,10,0.4,2,3,0.667,0.615,0,0,0,0,5,5,1,3,0,0,3,16
2014,Evan Turner,SF,25,IND,12,0,149,15,35,0.429,4,7,0.571,11,28,0.393,0.486,5,5,1,0,26,26,19,4,0,11,9,39
2014,Beno Udrih,SG,31,MEM,7,0,115,21,45,0.467,4,12,0.333,17,33,0.515,0.511,9,13,0.692,2,10,12,12,3,0,9,11,55
2014,Jonas Valanciunas,C,21,TOR,7,7,200,31,49,0.633,0,0,0,31,49,0.633,0.633,14,22,0.636,19,49,68,2,0,7,19,22,76
2014,Greivis Vasquez,SG,27,TOR,7,0,190,27,64,0.422,10,27,0.37,17,37,0.459,0.5,7,9,0.778,3,23,26,36,4,1,10,22,71
2014,Dwyane Wade,SG,32,MIA,20,20,693,139,278,0.5,9,24,0.375,130,254,0.512,0.516,69,90,0.767,16,61,77,77,30,5,54,55,356
2014,Kemba Walker,PG,23,CHA,4,4,153,26,55,0.473,12,24,0.5,14,31,0.452,0.582,14,18,0.778,1,14,15,24,8,3,15,6,78
2014,John Wall,PG,23,WAS,11,11,420,60,164,0.366,7,32,0.219,53,132,0.402,0.387,52,68,0.765,5,39,44,78,18,8,36,29,179
2014,C.J. Watson,PG,29,IND,19,0,342,37,90,0.411,16,40,0.4,21,50,0.42,0.5,17,28,0.607,3,37,40,18,16,1,14,28,107
2014,Earl Watson,PG,34,POR,4,0,14,0,1,0,0,1,0,0,0,0,0,0,0,0,0,1,1,1,0,0,1,1,0
2014,Martell Webster,SF,27,WAS,11,0,195,15,41,0.366,6,26,0.231,9,15,0.6,0.439,6,9,0.667,4,21,25,5,4,5,4,14,42
2014,David West,PF,33,IND,19,19,687,121,245,0.494,2,10,0.2,119,235,0.506,0.498,43,61,0.705,24,104,128,75,14,15,43,57,287
2014,Russell Westbrook,PG,25,OKC,19,19,735,167,398,0.42,28,100,0.28,139,298,0.466,0.455,145,164,0.884,45,93,138,153,41,6,83,62,507
2014,D.J. White,PF,27,CHA,1,0,3,0,0,,0,0,0,0,0,0,,0,0,0,0,2,2,0,0,0,1,0,0
2014,Deron Williams,PG,29,BRK,12,12,428,60,152,0.395,18,53,0.34,42,99,0.424,0.454,36,45,0.8,7,31,38,70,13,2,27,31,174
2014,Lou Williams,PG,27,ATL,7,0,133,19,50,0.38,5,16,0.313,14,34,0.412,0.43,15,16,0.938,0,16,16,8,7,1,13,10,58
2014,Mo Williams,PG,31,POR,8,0,187,22,59,0.373,5,21,0.238,17,38,0.447,0.415,10,11,0.909,2,10,12,15,3,0,14,24,59
2014,Brandan Wright,C,26,DAL,6,0,90,15,18,0.833,0,0,0,15,18,0.833,0.833,3,6,0.5,5,7,12,8,2,6,2,8,33
2014,Dorell Wright,SF,28,POR,8,0,88,7,19,0.368,4,12,0.333,3,7,0.429,0.474,11,15,0.733,2,14,16,3,3,9,5,8,29
2014,Cody Zeller,C,21,CHA,4,0,53,3,9,0.333,0,0,0,3,9,0.333,0.333,2,4,0.5,5,4,9,2,0,3,2,3,8
2015,Jordan Adams,SG,20,MEM,4,0,10,2,3,0.667,1,1,1,1,2,0.5,0.833,2,4,0.5,0,1,1,0,1,0,0,0,7
2015,Arron Afflalo,SG,29,POR,3,3,60,2,12,0.167,1,4,0.25,1,8,0.125,0.208,0,1,0,0,7,7,2,0,0,3,6,5
2015,Alexis Ajinca,C,26,NOP,3,0,10,4,4,1,0,0,0,4,4,1,1,0,0,0,0,1,1,1,1,0,0,2,8
2015,LaMarcus Aldridge,PF,29,POR,5,5,208,37,112,0.33,3,11,0.273,34,101,0.337,0.344,32,36,0.889,21,35,56,9,2,12,8,16,109
2015,Tony Allen,SG,33,MEM,10,9,279,28,57,0.491,1,7,0.143,27,50,0.54,0.5,9,12,0.75,14,38,52,15,24,11,13,27,66
2015,Al-Farouq Aminu,SF,24,DAL,5,2,150,17,31,0.548,7,11,0.636,10,20,0.5,0.661,15,19,0.789,14,22,36,6,10,8,6,15,56
2015,Alan Anderson,SG,32,BRK,6,0,142,25,41,0.61,10,16,0.625,15,25,0.6,0.732,6,9,0.667,2,19,21,7,4,1,8,9,66
2015,Ryan Anderson,PF,26,NOP,4,0,95,16,36,0.444,5,12,0.417,11,24,0.458,0.514,6,6,1,7,10,17,9,0,2,4,12,43
2015,Giannis Antetokounmpo,SG,20,MIL,6,6,201,26,71,0.366,0,1,0,26,70,0.371,0.366,17,23,0.739,12,30,42,16,3,9,11,18,69
2015,Pero Antic,C,32,ATL,15,1,199,16,50,0.32,11,32,0.344,5,18,0.278,0.43,20,25,0.8,9,34,43,4,2,3,5,38,63
2015,Trevor Ariza,SF,29,HOU,17,17,655,75,176,0.426,36,96,0.375,39,80,0.488,0.528,38,42,0.905,18,91,109,44,30,2,23,51,224
2015,Omer Asik,C,28,NOP,4,4,79,2,10,0.2,0,0,0,2,10,0.2,0.2,4,7,0.571,12,17,29,6,5,0,5,10,8
2015,Jeff Ayres,PF,27,SAS,3,0,12,0,1,0,0,0,0,0,1,0,0,0,0,0,0,3,3,2,0,0,0,0,0
2015,Leandro Barbosa,SG,32,GSW,21,0,229,39,88,0.443,8,23,0.348,31,65,0.477,0.489,18,22,0.818,8,19,27,18,6,1,12,24,104
2015,J.J. Barea,PG,30,DAL,5,2,154,25,57,0.439,4,16,0.25,21,41,0.512,0.474,5,6,0.833,5,19,24,37,4,0,14,17,59
2015,Harrison Barnes,SF,22,GSW,21,21,681,88,200,0.44,22,62,0.355,66,138,0.478,0.495,25,34,0.735,45,65,110,32,17,11,22,45,223
2015,Matt Barnes,SF,34,LAC,14,14,409,38,100,0.38,16,60,0.267,22,40,0.55,0.46,15,20,0.75,16,55,71,22,20,10,16,54,107
2015,Brandon Bass,PF,29,BOS,4,4,86,7,20,0.35,0,0,0,7,20,0.35,0.35,6,10,0.6,3,5,8,10,1,3,3,4,20
2015,Nicolas Batum,SF,26,POR,5,5,209,24,70,0.343,13,39,0.333,11,31,0.355,0.436,10,13,0.769,6,37,43,26,1,1,12,11,71
2015,Jerryd Bayless,PG,26,MIL,6,0,120,12,35,0.343,2,7,0.286,10,28,0.357,0.371,13,17,0.765,4,11,15,18,2,2,4,12,39
2015,Aron Baynes,C,28,SAS,4,0,40,3,10,0.3,0,0,0,3,10,0.3,0.3,3,3,1,3,7,10,1,0,0,3,9,9
2015,Kent Bazemore,SG,25,ATL,16,2,303,30,71,0.423,6,28,0.214,24,43,0.558,0.465,21,31,0.677,3,50,53,13,11,9,11,25,87
2015,Bradley Beal,SG,21,WAS,10,10,418,81,200,0.405,23,63,0.365,58,137,0.423,0.463,49,59,0.831,14,41,55,46,16,7,26,19,234
2015,Marco Belinelli,SG,28,SAS,7,0,116,20,39,0.513,14,30,0.467,6,9,0.667,0.692,11,13,0.846,2,11,13,10,2,0,5,10,65
2015,Steve Blake,PG,34,POR,5,0,43,2,11,0.182,1,8,0.125,1,3,0.333,0.227,2,2,1,0,1,1,8,0,1,2,4,7
2015,Bojan Bogdanovic,SF,25,BRK,6,5,206,23,59,0.39,11,33,0.333,12,26,0.462,0.483,5,7,0.714,3,20,23,10,4,2,8,12,62
2015,Andrew Bogut,C,30,GSW,19,18,440,42,75,0.56,0,1,0,42,74,0.568,0.56,5,13,0.385,41,112,153,36,11,34,26,69,89
2015,Matt Bonner,PF,34,SAS,7,0,36,2,10,0.2,2,9,0.222,0,1,0,0.3,0,0,0,0,6,6,1,0,1,1,8,6
2015,Avery Bradley,SG,24,BOS,4,4,133,19,50,0.38,5,19,0.263,14,31,0.452,0.43,6,7,0.857,3,12,15,3,3,0,3,13,49
2015,Elton Brand,C,35,ATL,3,0,4,0,1,0,0,0,0,0,1,0,0,1,2,0.5,0,1,1,0,0,0,0,3,1
2015,Corey Brewer,SF,28,HOU,17,0,428,72,167,0.431,12,42,0.286,60,125,0.48,0.467,35,55,0.636,11,36,47,19,11,4,15,48,191
2015,Aaron Brooks,PG,30,CHI,12,0,132,21,61,0.344,8,26,0.308,13,35,0.371,0.41,4,7,0.571,3,15,18,11,3,1,9,16,54
2015,Markel Brown,SG,23,BRK,2,1,10,2,5,0.4,0,2,0,2,3,0.667,0.4,2,2,1,2,0,2,1,0,0,2,0,6
2015,Jimmy Butler,SG,25,CHI,12,12,506,94,213,0.441,28,72,0.389,66,141,0.468,0.507,59,72,0.819,18,49,67,38,29,9,21,27,275
2015,Rasual Butler,SF,35,WAS,2,0,7,0,1,0,0,1,0,0,0,0,0,0,0,0,0,1,1,1,0,0,0,2,0
2015,Will Bynum,SG,32,WAS,3,0,31,7,14,0.5,1,2,0.5,6,12,0.5,0.536,4,5,0.8,2,1,3,3,2,1,5,6,19
2015,Nick Calathes,SG,25,MEM,9,3,126,12,36,0.333,6,13,0.462,6,23,0.261,0.417,3,8,0.375,1,15,16,16,9,1,10,15,33
2015,Clint Capela,C,20,HOU,17,0,127,21,31,0.677,0,0,0,21,31,0.677,0.677,15,29,0.517,13,29,42,5,3,9,3,19,57
2015,DeMarre Carroll,SF,28,ATL,16,16,558,86,177,0.486,29,72,0.403,57,105,0.543,0.568,32,41,0.78,26,71,97,32,18,5,15,36,233
2015,Vince Carter,SG,38,MEM,11,0,196,27,67,0.403,7,28,0.25,20,39,0.513,0.455,8,9,0.889,13,34,47,11,7,2,7,17,69
2015,Michael Carter-Williams,PG,23,MIL,6,6,191,33,78,0.423,0,5,0,33,73,0.452,0.423,7,12,0.583,1,26,27,29,7,6,16,14,73
2015,Tyson Chandler,C,32,DAL,5,5,160,19,29,0.655,0,0,0,19,29,0.655,0.655,13,26,0.5,27,27,54,1,3,6,5,16,51
2015,Earl Clark,PF,27,BRK,2,0,13,2,10,0.2,2,3,0.667,0,7,0,0.3,0,0,0,0,2,2,0,1,0,0,1,6
2015,Norris Cole,PG,26,NOP,4,0,106,15,36,0.417,3,14,0.214,12,22,0.545,0.458,2,3,0.667,1,6,7,7,0,1,8,15,35
2015,Mike Conley,PG,27,MEM,8,8,243,41,96,0.427,10,33,0.303,31,63,0.492,0.479,23,28,0.821,0,9,9,40,11,0,12,10,115
2015,Allen Crabbe,SG,22,POR,2,1,39,4,5,0.8,2,2,1,2,3,0.667,1,0,0,0,0,3,3,1,2,1,1,1,10
2015,Jamal Crawford,SG,34,LAC,14,0,379,67,186,0.36,18,74,0.243,49,112,0.438,0.409,26,30,0.867,6,24,30,27,13,3,17,34,178
2015,Jae Crowder,SF,24,BOS,4,1,100,15,29,0.517,3,10,0.3,12,19,0.632,0.569,10,13,0.769,8,12,20,8,4,3,5,14,43
2015,Dante Cunningham,PF,27,NOP,4,0,75,9,11,0.818,0,0,0,9,11,0.818,0.818,3,3,1,4,14,18,2,3,4,0,7,21
2015,Stephen Curry,PG,26,GSW,21,21,826,200,439,0.456,98,232,0.422,102,207,0.493,0.567,96,115,0.835,20,85,105,134,39,3,82,47,594
2015,Luigi Datome,SF,27,BOS,3,0,14,2,6,0.333,0,2,0,2,4,0.5,0.333,0,0,0,0,1,1,1,0,0,0,4,4
2015,Anthony Davis,PF,21,NOP,4,4,172,47,87,0.54,0,2,0,47,85,0.553,0.54,32,36,0.889,9,35,44,8,5,12,13,12,126
2015,Glen Davis,PF,29,LAC,14,0,144,17,38,0.447,0,1,0,17,37,0.459,0.447,7,9,0.778,9,18,27,3,5,5,9,33,41
2015,Matthew Dellavedova,SG,24,CLE,20,7,497,47,136,0.346,24,76,0.316,23,60,0.383,0.434,25,32,0.781,10,31,41,53,9,0,35,52,143
2015,DeMar DeRozan,SG,25,TOR,4,4,159,32,80,0.4,3,8,0.375,29,72,0.403,0.419,14,17,0.824,5,20,25,23,6,0,10,12,81
2015,Boris Diaw,PF,32,SAS,7,0,198,34,71,0.479,4,18,0.222,30,53,0.566,0.507,9,13,0.692,13,30,43,25,5,3,9,24,81
2015,Joey Dorsey,PF,31,HOU,6,0,13,0,2,0,0,0,0,0,2,0,0,1,2,0.5,1,3,4,2,0,0,1,2,1
2015,Jared Dudley,SG,29,MIL,6,0,110,14,30,0.467,8,14,0.571,6,16,0.375,0.6,4,7,0.571,3,8,11,8,12,2,5,12,40
2015,Tim Duncan,C,38,SAS,7,7,250,53,90,0.589,0,1,0,53,89,0.596,0.589,19,34,0.559,19,59,78,23,9,10,7,26,125
2015,Mike Dunleavy,SF,34,CHI,12,12,389,43,88,0.489,27,56,0.482,16,32,0.5,0.642,18,19,0.947,7,41,48,31,10,5,15,31,131
2015,Monta Ellis,SG,29,DAL,5,5,197,52,111,0.468,11,30,0.367,41,81,0.506,0.518,15,20,0.75,4,12,16,26,10,3,16,18,130
2015,Tyler Ennis,PG,20,MIL,1,0,16,2,9,0.222,1,5,0.2,1,4,0.25,0.278,0,0,0,3,1,4,3,0,0,0,1,5
2015,Tyreke Evans,SG,25,NOP,4,4,125,14,43,0.326,2,11,0.182,12,32,0.375,0.349,10,17,0.588,3,17,20,20,5,1,6,10,40
2015,Festus Ezeli,C,25,GSW,20,0,183,27,50,0.54,0,0,0,27,50,0.54,0.54,16,29,0.552,24,38,62,6,1,10,12,25,70
2015,Raymond Felton,PG,30,DAL,3,1,36,4,15,0.267,0,4,0,4,11,0.364,0.267,3,3,1,1,6,7,4,0,0,0,1,11
2015,Tim Frazier,PG,24,POR,2,0,3,0,1,0,0,0,0,0,1,0,0,0,0,0,0,0,0,0,0,0,1,0,0
2015,Joel Freeland,C,27,POR,2,0,7,0,0,,0,0,0,0,0,0,,0,0,0,0,1,1,0,1,0,0,0,0
2015,Marc Gasol,C,30,MEM,11,11,416,71,180,0.394,0,2,0,71,178,0.399,0.394,75,88,0.852,19,94,113,49,10,19,16,33,217
2015,Pau Gasol,PF,34,CHI,10,10,317,56,115,0.487,0,4,0,56,111,0.505,0.487,32,42,0.762,17,77,94,31,5,21,21,18,144
2015,Alonzo Gee,SF,27,POR,1,0,3,0,0,,0,0,0,0,0,0,,0,0,0,0,1,1,1,0,0,0,0,0
2015,Taj Gibson,PF,29,CHI,12,2,276,34,72,0.472,0,0,0,34,72,0.472,0.472,21,30,0.7,25,41,66,12,4,12,11,25,89
2015,Manu Ginobili,SG,37,SAS,7,0,131,15,43,0.349,8,22,0.364,7,21,0.333,0.442,18,23,0.783,4,20,24,32,4,6,14,19,56
2015,Drew Gooden,PF,33,WAS,10,0,178,23,61,0.377,12,26,0.462,11,35,0.314,0.475,10,13,0.769,13,42,55,8,2,10,14,21,68
2015,Eric Gordon,SG,26,NOP,4,4,143,28,63,0.444,13,32,0.406,15,31,0.484,0.548,5,6,0.833,2,7,9,15,2,2,10,11,74
2015,Marcin Gortat,C,30,WAS,10,10,307,54,86,0.628,0,0,0,54,86,0.628,0.628,16,24,0.667,27,61,88,22,6,11,16,29,124
2015,Danny Green,SG,27,SAS,7,7,204,21,61,0.344,12,40,0.3,9,21,0.429,0.443,4,6,0.667,7,15,22,15,7,7,5,12,58
2015,Draymond Green,PF,24,GSW,21,21,784,100,240,0.417,24,91,0.264,76,149,0.51,0.467,64,87,0.736,46,166,212,109,38,25,58,89,288
2015,JaMychal Green,PF,24,MEM,5,0,8,0,2,0,0,1,0,0,1,0,0,2,2,1,0,3,3,0,1,1,0,1,2
2015,Jeff Green,SF,28,MEM,11,2,298,36,108,0.333,4,18,0.222,32,90,0.356,0.352,22,26,0.846,9,43,52,19,5,5,16,18,98
2015,Blake Griffin,PF,25,LAC,14,14,557,140,274,0.511,1,7,0.143,139,267,0.521,0.513,76,106,0.717,38,140,178,86,14,14,45,43,357
2015,Jorge Gutierrez,PG,26,MIL,1,0,12,1,2,0.5,0,0,0,1,2,0.5,0.5,0,0,0,0,1,1,1,0,0,0,1,2
2015,Tyler Hansbrough,PF,29,TOR,4,2,48,1,5,0.2,0,0,0,1,5,0.2,0.2,3,4,0.75,1,5,6,3,2,1,2,8,5
2015,James Harden,SG,25,HOU,17,17,636,129,294,0.439,41,107,0.383,88,187,0.471,0.509,163,178,0.916,12,85,97,128,28,7,77,49,462
2015,Devin Harris,PG,31,DAL,4,0,74,8,23,0.348,0,11,0,8,12,0.667,0.348,8,9,0.889,1,7,8,4,2,0,4,10,24
2015,Joe Harris,SG,23,CLE,6,0,16,2,6,0.333,1,3,0.333,1,3,0.333,0.417,3,4,0.75,0,1,1,1,0,0,1,1,8
2015,Spencer Hawes,PF,26,LAC,8,0,57,9,17,0.529,3,6,0.5,6,11,0.545,0.618,2,2,1,3,10,13,5,2,3,1,12,23
2015,Brendan Haywood,C,35,CLE,1,0,2,0,1,0,0,0,0,0,1,0,0,0,0,0,0,0,0,0,0,0,0,0,0
2015,John Henson,C,24,MIL,6,0,153,24,41,0.585,0,1,0,24,40,0.6,0.585,5,14,0.357,21,27,48,4,5,10,11,14,53
2015,Nene Hilario,PF,32,WAS,10,10,257,34,76,0.447,0,0,0,34,76,0.447,0.447,11,23,0.478,25,41,66,15,9,3,14,32,79
2015,Kirk Hinrich,SG,34,CHI,10,0,126,9,19,0.474,6,10,0.6,3,9,0.333,0.632,2,3,0.667,0,5,5,11,3,1,1,14,26
2015,Jrue Holiday,PG,24,NOP,3,0,55,7,19,0.368,1,4,0.25,6,15,0.4,0.395,4,4,1,2,1,3,13,2,1,5,3,19
2015,Justin Holiday,SG,25,GSW,5,0,11,1,2,0.5,1,1,1,0,1,0,0.75,0,0,0,0,1,1,1,0,0,2,1,3
2015,Al Horford,C,28,ATL,16,16,522,107,211,0.507,2,9,0.222,105,202,0.52,0.512,15,20,0.75,40,98,138,59,13,23,25,34,231
2015,Dwight Howard,C,29,HOU,17,17,574,105,182,0.577,0,0,0,105,182,0.577,0.577,68,165,0.412,62,176,238,20,23,39,37,60,278
2015,Lester Hudson,SG,30,LAC,7,0,38,6,14,0.429,2,7,0.286,4,7,0.571,0.5,0,0,0,0,1,1,7,2,1,3,8,14
2015,Kris Humphries,PF,29,WAS,1,0,5,1,1,1,0,0,0,1,1,1,1,0,0,0,0,3,3,0,0,0,0,1,2
2015,Andre Iguodala,SF,31,GSW,21,3,635,81,171,0.474,29,82,0.354,52,89,0.584,0.558,27,65,0.415,16,78,94,75,25,7,14,42,218
2015,Ersan Ilyasova,PF,27,MIL,6,6,142,20,61,0.328,5,23,0.217,15,38,0.395,0.369,7,10,0.7,6,17,23,3,5,3,5,10,52
2015,Kyrie Irving,PG,22,CLE,13,13,464,81,185,0.438,27,60,0.45,54,125,0.432,0.511,58,69,0.841,10,37,47,50,17,11,20,29,247
2015,Jarrett Jack,PG,31,BRK,6,0,153,28,54,0.519,5,15,0.333,23,39,0.59,0.565,13,13,1,2,23,25,27,7,1,20,14,74
2015,Bernard James,C,29,DAL,1,0,2,0,0,,0,0,0,0,0,0,,0,0,0,0,0,0,0,0,0,0,0,0
2015,LeBron James,SF,30,CLE,20,20,844,227,544,0.417,25,110,0.227,202,434,0.465,0.44,122,167,0.731,37,189,226,169,33,21,82,58,601
2015,Richard Jefferson,SF,34,DAL,4,2,51,5,14,0.357,3,8,0.375,2,6,0.333,0.464,2,2,1,0,2,2,1,2,0,3,9,15
2015,John Jenkins,SG,23,ATL,4,0,21,4,6,0.667,2,4,0.5,2,2,1,0.833,0,0,0,1,2,3,0,0,0,0,2,10
2015,Jonas Jerebko,PF,27,BOS,4,0,68,5,15,0.333,0,4,0,5,11,0.455,0.333,1,2,0.5,4,10,14,1,2,1,3,9,11
2015,Amir Johnson,PF,27,TOR,4,2,112,20,29,0.69,0,1,0,20,28,0.714,0.69,6,12,0.5,7,21,28,4,1,3,7,16,46
2015,James Johnson,PF,27,TOR,2,0,12,2,6,0.333,0,0,0,2,6,0.333,0.333,0,6,0,0,2,2,1,0,0,0,0,4
2015,Joe Johnson,SG,33,BRK,6,6,249,34,94,0.362,12,41,0.293,22,53,0.415,0.426,19,24,0.792,5,41,46,29,7,0,5,16,99
2015,Nick Johnson,SG,22,HOU,9,0,49,4,17,0.235,1,7,0.143,3,10,0.3,0.265,3,3,1,1,3,4,4,0,1,4,7,12
2015,Dahntay Jones,SF,34,LAC,11,0,18,2,2,1,0,0,0,2,2,1,1,0,0,0,0,1,1,0,2,0,0,7,4
2015,James Jones,SF,34,CLE,20,0,311,26,75,0.347,22,64,0.344,4,11,0.364,0.493,13,14,0.929,1,28,29,9,8,3,5,42,87
2015,Terrence Jones,PF,23,HOU,17,9,401,67,159,0.421,3,19,0.158,64,140,0.457,0.431,36,54,0.667,29,52,81,17,8,12,16,31,173
2015,DeAndre Jordan,C,26,LAC,14,14,482,58,81,0.716,0,0,0,58,81,0.716,0.716,67,157,0.427,49,138,187,16,16,33,17,42,183
2015,Jerome Jordan,C,28,BRK,1,0,5,0,2,0,0,0,0,0,2,0,0,0,0,0,1,1,2,0,0,0,1,0,0
2015,Cory Joseph,PG,23,SAS,4,0,22,5,6,0.833,0,0,0,5,6,0.833,0.833,1,2,0.5,0,1,1,0,0,1,1,2,11
2015,Chris Kaman,C,32,POR,3,0,37,4,8,0.5,0,0,0,4,8,0.5,0.5,1,1,1,5,9,14,3,0,0,3,5,9
2015,Kyle Korver,SG,33,ATL,14,14,526,52,133,0.391,39,110,0.355,13,23,0.565,0.538,13,16,0.813,1,69,70,33,20,15,21,27,156
2015,Kosta Koufos,C,25,MEM,11,0,127,17,31,0.548,0,0,0,17,31,0.548,0.548,3,5,0.6,19,20,39,4,4,6,1,14,37
2015,Courtney Lee,SG,29,MEM,11,11,367,55,100,0.55,14,30,0.467,41,70,0.586,0.62,22,23,0.957,3,25,28,24,12,0,13,24,146
2015,David Lee,PF,31,GSW,13,0,107,16,40,0.4,0,0,0,16,40,0.4,0.4,8,15,0.533,11,23,34,8,3,2,2,17,40
2015,Kawhi Leonard,SF,23,SAS,7,7,250,52,109,0.477,11,26,0.423,41,83,0.494,0.528,27,35,0.771,13,39,52,18,8,4,15,18,142
2015,Meyers Leonard,C,22,POR,5,0,106,14,21,0.667,10,13,0.769,4,8,0.5,0.905,1,2,0.5,6,27,33,5,2,2,3,17,39
2015,Jon Leuer,PF,25,MEM,4,0,9,2,4,0.5,0,0,0,2,4,0.5,0.5,0,0,0,2,3,5,0,0,0,0,1,4
2015,Damian Lillard,PG,24,POR,5,5,201,39,96,0.406,5,31,0.161,34,65,0.523,0.432,25,32,0.781,2,18,20,23,2,3,12,15,108
2015,Shaun Livingston,PG,29,GSW,21,0,375,42,79,0.532,0,1,0,42,78,0.538,0.532,21,25,0.84,13,38,51,38,8,5,21,32,105
2015,Brook Lopez,C,26,BRK,6,6,234,43,87,0.494,0,0,0,43,87,0.494,0.494,33,40,0.825,20,34,54,5,4,13,6,18,119
2015,Robin Lopez,C,26,POR,5,5,117,9,15,0.6,0,0,0,9,15,0.6,0.6,8,8,1,9,13,22,3,1,5,5,15,26
2015,Kevin Love,PF,26,CLE,4,4,107,17,41,0.415,9,21,0.429,8,20,0.4,0.524,14,19,0.737,6,22,28,10,1,2,6,12,57
2015,Kyle Lowry,PG,28,TOR,4,4,131,18,57,0.316,5,23,0.217,13,34,0.382,0.36,8,11,0.727,7,15,22,19,5,0,12,18,49
2015,Shelvin Mack,PG,24,ATL,10,0,99,15,39,0.385,6,21,0.286,9,18,0.5,0.462,3,6,0.5,2,9,11,10,8,0,2,7,39
2015,Shawn Marion,SF,36,CLE,6,0,25,1,6,0.167,0,0,0,1,6,0.167,0.167,0,0,0,2,4,6,1,2,0,0,1,2
2015,O.J. Mayo,SG,27,MIL,6,0,156,18,54,0.333,6,19,0.316,12,35,0.343,0.389,12,12,1,1,19,20,18,7,1,9,14,54
2015,James Michael McAdoo,PF,22,GSW,5,0,10,2,3,0.667,0,0,0,2,3,0.667,0.667,0,0,0,1,3,4,0,0,1,1,0,4
2015,CJ McCollum,SG,23,POR,5,1,166,32,67,0.478,11,23,0.478,21,44,0.477,0.56,10,13,0.769,1,19,20,2,6,1,6,13,85
2015,Doug McDermott,SF,23,CHI,3,0,10,1,3,0.333,1,2,0.5,0,1,0,0.5,2,2,1,1,1,2,1,0,0,1,0,5
2015,Khris Middleton,SF,23,MIL,6,6,232,35,92,0.38,11,34,0.324,24,58,0.414,0.44,14,15,0.933,7,15,22,12,14,3,10,14,95
2015,Mike Miller,SF,34,CLE,9,1,65,3,5,0.6,3,5,0.6,0,0,0,0.9,0,0,0,0,10,10,0,1,1,1,6,9
2015,Patty Mills,PG,26,SAS,7,0,112,21,42,0.5,16,28,0.571,5,14,0.357,0.69,13,13,1,4,15,19,8,2,0,5,15,71
2015,Paul Millsap,PF,29,ATL,16,15,566,85,209,0.407,15,49,0.306,70,160,0.438,0.443,58,78,0.744,36,103,139,55,25,14,34,52,243
2015,Nikola Mirotic,PF,23,CHI,11,0,164,20,66,0.303,7,30,0.233,13,36,0.361,0.356,16,20,0.8,7,23,30,9,6,6,8,22,63
2015,Nazr Mohammed,C,37,CHI,3,0,14,2,7,0.286,0,1,0,2,6,0.333,0.286,0,0,0,3,2,5,0,0,1,0,0,4
2015,E'Twaun Moore,SG,25,CHI,3,0,9,2,6,0.333,1,1,1,1,5,0.2,0.417,0,0,0,0,3,3,0,2,0,0,1,5
2015,Darius Morris,PG,24,BRK,1,0,5,0,1,0,0,0,0,0,1,0,0,0,0,0,0,0,0,0,0,0,0,0,0
2015,Timofey Mozgov,C,28,CLE,20,20,529,74,148,0.5,0,0,0,74,148,0.5,0.5,64,81,0.79,57,89,146,13,8,36,37,57,212
2015,Mike Muscala,PF,23,ATL,10,0,102,20,33,0.606,2,8,0.25,18,25,0.72,0.636,0,0,0,8,10,18,1,1,3,4,13,42
2015,Joakim Noah,C,29,CHI,12,12,395,31,76,0.408,0,0,0,31,76,0.408,0.408,7,20,0.35,45,87,132,38,10,14,20,37,69
2015,Dirk Nowitzki,PF,36,DAL,5,5,181,38,84,0.452,4,17,0.235,34,67,0.507,0.476,26,28,0.929,4,48,52,12,2,2,10,16,106
2015,Johnny O'Bryant,PF,21,MIL,1,0,12,3,8,0.375,0,0,0,3,8,0.375,0.375,0,0,0,1,2,3,0,0,0,0,1,6
2015,Kelly Olynyk,C,23,BOS,4,0,53,7,13,0.538,3,6,0.5,4,7,0.571,0.654,1,2,0.5,2,3,5,2,2,2,4,12,18
2015,Zaza Pachulia,C,30,MIL,6,6,129,16,40,0.4,0,0,0,16,40,0.4,0.4,8,13,0.615,11,29,40,9,10,3,5,15,40
2015,Kostas Papanikolaou,SF,24,HOU,8,0,21,1,4,0.25,0,3,0,1,1,1,0.25,1,2,0.5,0,2,2,0,0,0,5,4,3
2015,Tony Parker,PG,32,SAS,7,7,210,33,91,0.363,0,9,0,33,82,0.402,0.363,10,17,0.588,4,19,23,25,2,0,11,14,76
2015,Chandler Parsons,SF,26,DAL,1,1,37,5,15,0.333,0,4,0,5,11,0.455,0.333,0,0,0,0,6,6,2,0,0,1,1,10
2015,Patrick Patterson,PF,25,TOR,4,0,106,15,27,0.556,7,15,0.467,8,12,0.667,0.685,4,4,1,4,10,14,5,3,0,3,5,41
2015,Chris Paul,PG,29,LAC,12,12,445,95,189,0.503,27,65,0.415,68,124,0.548,0.574,48,51,0.941,7,46,53,105,22,3,26,37,265
2015,Kendrick Perkins,C,30,CLE,8,0,33,2,8,0.25,0,0,0,2,8,0.25,0.25,6,10,0.6,2,7,9,0,0,3,4,6,10
2015,Paul Pierce,SF,37,WAS,10,10,298,48,99,0.485,33,63,0.524,15,36,0.417,0.652,17,20,0.85,0,42,42,9,6,7,10,33,146
2015,Mason Plumlee,C,24,BRK,6,0,49,4,6,0.667,0,0,0,4,6,0.667,0.667,4,11,0.364,2,6,8,2,4,2,3,10,12
2015,Miles Plumlee,C,26,MIL,1,0,16,1,8,0.125,0,0,0,1,8,0.125,0.125,1,2,0.5,3,3,6,1,0,1,1,1,3
2015,Quincy Pondexter,SF,26,NOP,4,4,124,10,28,0.357,3,10,0.3,7,18,0.389,0.411,6,7,0.857,3,17,20,12,7,0,1,13,29
2015,Otto Porter,SF,21,WAS,10,0,331,39,88,0.443,12,32,0.375,27,56,0.482,0.511,10,21,0.476,24,56,80,18,12,2,6,16,100
2015,Dwight Powell,PF,23,DAL,2,0,3,0,1,0,0,0,0,0,1,0,0,0,0,0,0,1,1,1,0,0,0,1,0
2015,Phil Pressey,PG,23,BOS,2,0,5,0,3,0,0,1,0,0,2,0,0,0,0,0,1,0,1,0,0,1,0,1,0
2015,Pablo Prigioni,PG,37,HOU,17,0,293,19,57,0.333,12,41,0.293,7,16,0.438,0.439,3,4,0.75,6,13,19,39,15,0,12,40,53
2015,Zach Randolph,PF,33,MEM,11,11,382,71,168,0.423,1,5,0.2,70,163,0.429,0.426,29,33,0.879,32,61,93,23,6,0,23,37,172
2015,J.J. Redick,SG,30,LAC,14,14,540,70,161,0.435,35,88,0.398,35,73,0.479,0.543,33,35,0.943,0,30,30,24,10,5,26,36,208
2015,Austin Rivers,PG,22,LAC,14,2,250,46,105,0.438,13,35,0.371,33,70,0.471,0.5,12,19,0.632,6,18,24,16,10,4,12,28,117
2015,Rajon Rondo,PG,28,DAL,2,2,37,9,20,0.45,1,2,0.5,8,18,0.444,0.475,0,0,0,1,1,2,6,0,0,2,6,19
2015,Derrick Rose,PG,26,CHI,12,12,454,93,235,0.396,23,66,0.348,70,169,0.414,0.445,35,39,0.897,13,45,58,78,14,6,38,22,244
2015,Terrence Ross,SF,23,TOR,4,4,107,11,29,0.379,6,18,0.333,5,11,0.455,0.483,0,0,0,0,6,6,4,3,4,2,10,28
2015,Brandon Rush,SG,29,GSW,3,0,7,1,6,0.167,1,2,0.5,0,4,0,0.25,0,0,0,1,2,3,0,0,0,0,2,3
2015,Dennis Schroder,PG,21,ATL,16,0,290,56,145,0.386,8,34,0.235,48,111,0.432,0.414,24,28,0.857,5,24,29,62,9,0,27,28,144
2015,Mike Scott,PF,26,ATL,11,0,172,21,55,0.382,4,26,0.154,17,29,0.586,0.418,4,4,1,16,30,46,5,5,0,7,16,50
2015,Kevin Seraphin,C,25,WAS,6,0,72,15,31,0.484,0,0,0,15,31,0.484,0.484,3,6,0.5,3,16,19,2,2,1,4,10,33
2015,Ramon Sessions,PG,28,WAS,10,3,218,26,70,0.371,10,25,0.4,16,45,0.356,0.443,13,19,0.684,2,22,24,23,4,1,10,14,75
2015,Iman Shumpert,SG,24,CLE,20,16,695,59,164,0.36,33,93,0.355,26,71,0.366,0.46,30,40,0.75,23,75,98,23,25,16,13,50,181
2015,Marcus Smart,PG,20,BOS,4,3,90,14,29,0.483,3,13,0.231,11,16,0.688,0.534,8,15,0.533,5,6,11,5,1,1,4,12,39
2015,Greg Smith,PF,24,DAL,1,0,1,0,0,,0,0,0,0,0,0,,0,0,0,0,0,0,0,0,0,0,0,0
2015,J.R. Smith,SG,29,CLE,18,4,560,83,206,0.403,51,142,0.359,32,64,0.5,0.527,14,20,0.7,9,76,85,22,17,10,15,54,231
2015,Josh Smith,PF,29,HOU,17,8,396,85,194,0.438,27,71,0.38,58,123,0.472,0.508,32,74,0.432,26,70,96,46,9,17,38,41,229
2015,Russ Smith,PG,23,MEM,2,0,3,0,0,,0,0,0,0,0,0,,0,0,0,0,0,0,2,0,0,0,0,0
2015,Tony Snell,SF,23,CHI,11,0,140,15,44,0.341,9,27,0.333,6,17,0.353,0.443,4,4,1,1,16,17,6,0,3,5,13,43
2015,Marreese Speights,C,27,GSW,10,0,67,14,42,0.333,0,0,0,14,42,0.333,0.333,9,15,0.6,8,13,21,4,4,3,4,14,37
2015,Tiago Splitter,C,30,SAS,7,7,123,9,24,0.375,0,0,0,9,24,0.375,0.375,6,19,0.316,13,18,31,9,4,1,7,17,24
2015,Greg Stiemsma,C,29,TOR,1,0,2,2,2,1,0,0,0,2,2,1,1,1,2,0.5,0,0,0,0,0,0,0,0,5
2015,Amar'e Stoudemire,PF,32,DAL,5,0,75,15,35,0.429,0,0,0,15,35,0.429,0.429,9,13,0.692,7,9,16,3,1,3,7,16,39
2015,Jared Sullinger,PF,22,BOS,4,0,80,21,38,0.553,3,9,0.333,18,29,0.621,0.592,4,7,0.571,9,19,28,1,0,3,5,12,49
2015,Jeff Teague,PG,26,ATL,16,16,529,98,239,0.41,21,65,0.323,77,174,0.443,0.454,52,60,0.867,10,41,51,107,24,7,43,34,269
2015,Mirza Teletovic,PF,29,BRK,3,0,16,0,5,0,0,4,0,0,1,0,0,0,0,0,0,4,4,0,1,0,1,1,0
2015,Garrett Temple,SG,28,WAS,4,0,26,1,6,0.167,0,3,0,1,3,0.333,0.167,5,8,0.625,1,2,3,1,2,0,3,4,7
2015,Jason Terry,SG,37,HOU,17,17,487,57,134,0.425,29,82,0.354,28,52,0.538,0.534,13,16,0.813,6,32,38,48,15,2,20,46,156
2015,Isaiah Thomas,PG,25,BOS,4,0,119,18,54,0.333,3,18,0.167,15,36,0.417,0.361,31,32,0.969,1,11,12,28,3,0,14,10,70
2015,Klay Thompson,SG,24,GSW,21,21,761,149,334,0.446,57,146,0.39,92,188,0.489,0.531,36,45,0.8,9,72,81,54,16,19,41,64,391
2015,Tristan Thompson,PF,23,CLE,20,15,727,72,129,0.558,0,0,0,72,129,0.558,0.558,48,82,0.585,88,128,216,9,5,24,15,50,192
2015,Hedo Turkoglu,SF,35,LAC,11,0,55,4,17,0.235,2,13,0.154,2,4,0.5,0.294,0,0,0,1,6,7,4,4,1,2,10,10
2015,Evan Turner,SG,26,BOS,4,4,118,16,44,0.364,2,4,0.5,14,40,0.35,0.386,8,9,0.889,2,27,29,19,3,0,9,11,42
2015,Ekpe Udoh,PF,27,LAC,4,0,12,1,3,0.333,0,0,0,1,3,0.333,0.333,0,0,0,0,3,3,0,0,0,0,3,2
2015,Beno Udrih,PG,32,MEM,10,0,175,31,73,0.425,4,16,0.25,27,57,0.474,0.452,10,12,0.833,4,16,20,21,5,0,4,16,76
2015,Jonas Valanciunas,C,22,TOR,4,4,106,19,38,0.5,0,0,0,19,38,0.5,0.5,7,8,0.875,9,28,37,2,2,1,4,7,45
2015,Greivis Vasquez,PG,28,TOR,4,0,101,11,29,0.379,5,14,0.357,6,15,0.4,0.466,3,3,1,0,7,7,12,2,0,4,15,30
2015,Charlie Villanueva,PF,30,DAL,5,0,43,11,25,0.44,8,19,0.421,3,6,0.5,0.6,0,0,0,4,9,13,3,1,1,0,10,30
2015,John Wall,PG,24,WAS,7,7,273,43,110,0.391,3,17,0.176,40,93,0.43,0.405,33,39,0.846,5,28,33,83,10,10,27,13,122
2015,Gerald Wallace,SF,32,BOS,1,0,4,0,1,0,0,0,0,0,1,0,0,0,0,0,0,1,1,0,0,0,0,0,0
2015,Martell Webster,SF,28,WAS,1,0,4,1,2,0.5,0,1,0,1,1,1,0.5,0,0,0,0,0,0,0,0,0,0,0,2
2015,Deron Williams,PG,30,BRK,6,6,192,27,69,0.391,11,26,0.423,16,43,0.372,0.471,6,7,0.857,3,34,37,33,8,0,16,18,71
2015,Lou Williams,SG,28,TOR,4,0,102,16,51,0.314,4,21,0.19,12,30,0.4,0.353,15,18,0.833,2,5,7,5,6,0,3,9,51
2015,Thaddeus Young,PF,26,BRK,6,6,190,29,66,0.439,0,4,0,29,62,0.468,0.439,5,12,0.417,17,26,43,16,5,1,14,15,63
2015,Tyler Zeller,C,25,BOS,4,4,90,15,29,0.517,0,0,0,15,29,0.517,0.517,4,5,0.8,2,16,18,2,2,1,4,5,34
2016,Steven Adams,C,22,OKC,18,18,553,68,111,0.613,0,1,0,68,110,0.618,0.613,46,73,0.63,62,109,171,13,9,14,17,55,182
2016,Cole Aldrich,C,27,LAC,6,0,77,10,15,0.667,0,0,0,10,15,0.667,0.667,3,6,0.5,8,22,30,3,6,3,2,11,23
2016,LaMarcus Aldridge,PF,30,SAS,10,10,337,88,169,0.521,2,2,1,86,167,0.515,0.527,41,46,0.891,22,61,83,10,4,14,11,18,219
2016,Lavoy Allen,PF,26,IND,6,3,51,3,10,0.3,0,0,0,3,10,0.3,0.3,0,0,0,4,10,14,2,1,1,1,2,6
2016,Tony Allen,SG,34,MEM,4,2,94,10,33,0.303,1,7,0.143,9,26,0.346,0.318,9,13,0.692,6,5,11,3,5,2,6,11,30
2016,Al-Farouq Aminu,SF,25,POR,11,11,372,56,128,0.438,28,70,0.4,28,58,0.483,0.547,21,29,0.724,23,72,95,20,8,10,21,31,161
2016,Chris Andersen,C,37,MEM,4,2,79,5,12,0.417,0,0,0,5,12,0.417,0.417,5,8,0.625,13,18,31,3,2,3,5,4,15
2016,Justin Anderson,SF,22,DAL,5,1,95,17,37,0.459,4,13,0.308,13,24,0.542,0.514,9,14,0.643,9,11,20,7,4,3,5,12,47
2016,Kyle Anderson,SF,22,SAS,10,0,129,8,25,0.32,1,3,0.333,7,22,0.318,0.34,6,7,0.857,2,22,24,7,6,3,4,11,23
2016,Trevor Ariza,SF,30,HOU,5,5,181,13,51,0.255,4,28,0.143,9,23,0.391,0.294,3,4,0.75,7,14,21,4,13,1,12,16,33
2016,Jeff Ayres,C,28,LAC,2,0,2,1,1,1,0,0,0,1,1,1,1,1,1,1,0,0,0,0,0,0,0,0,3
2016,Leandro Barbosa,SG,33,GSW,23,0,254,51,88,0.58,11,28,0.393,40,60,0.667,0.642,16,21,0.762,11,16,27,15,11,1,11,24,129
2016,J.J. Barea,PG,31,DAL,4,2,100,11,34,0.324,1,8,0.125,10,26,0.385,0.338,2,2,1,0,6,6,20,0,0,11,8,25
2016,Harrison Barnes,SF,23,GSW,24,23,743,82,213,0.385,26,76,0.342,56,137,0.409,0.446,26,34,0.765,27,85,112,30,17,4,18,46,216
2016,Matt Barnes,SF,35,MEM,4,4,139,16,46,0.348,3,18,0.167,13,28,0.464,0.38,8,10,0.8,5,24,29,11,4,1,13,13,43
2016,Nicolas Batum,SF,27,CHO,5,2,144,17,45,0.378,6,22,0.273,11,23,0.478,0.444,17,20,0.85,2,16,18,10,2,0,8,6,57
2016,Aron Baynes,C,29,DET,4,0,44,4,9,0.444,0,0,0,4,9,0.444,0.444,2,3,0.667,3,5,8,2,0,0,3,4,10
2016,Kent Bazemore,SF,26,ATL,10,10,325,44,121,0.364,16,61,0.262,28,60,0.467,0.43,15,22,0.682,8,58,66,19,15,6,10,14,119
2016,Michael Beasley,PF,27,HOU,5,0,80,22,46,0.478,2,6,0.333,20,40,0.5,0.5,6,7,0.857,4,17,21,3,1,0,7,8,52
2016,Patrick Beverley,PG,27,HOU,5,5,129,10,37,0.27,3,14,0.214,7,23,0.304,0.311,6,6,1,4,18,22,11,2,2,4,17,29
2016,Bismack Biyombo,C,23,TOR,20,10,506,40,69,0.58,0,0,0,40,69,0.58,0.58,43,72,0.597,53,134,187,8,8,27,21,48,123
2016,Steve Blake,PG,35,DET,4,0,43,1,5,0.2,1,2,0.5,0,3,0,0.3,1,2,0.5,0,4,4,10,0,0,5,7,4
2016,Andrew Bogut,C,31,GSW,22,22,365,48,77,0.623,0,2,0,48,75,0.64,0.623,5,14,0.357,47,78,125,30,14,35,19,72,101
2016,Avery Bradley,SG,25,BOS,1,1,33,7,16,0.438,1,7,0.143,6,9,0.667,0.469,3,3,1,2,1,3,1,1,1,1,2,18
2016,Corey Brewer,SF,29,HOU,5,1,77,7,27,0.259,1,10,0.1,6,17,0.353,0.278,7,8,0.875,3,4,7,8,0,1,6,13,22
2016,Reggie Bullock,SF,24,DET,2,0,22,5,6,0.833,2,3,0.667,3,3,1,1,0,0,0,0,2,2,3,1,0,0,2,12
2016,Kentavious Caldwell-Pope,SG,22,DET,4,4,161,22,50,0.44,12,27,0.444,10,23,0.435,0.56,5,7,0.714,2,15,17,11,7,1,2,7,61
2016,Clint Capela,C,21,HOU,5,0,43,3,9,0.333,0,0,0,3,9,0.333,0.333,2,5,0.4,8,12,20,2,3,2,3,5,8
2016,DeMarre Carroll,SF,29,TOR,20,19,596,62,159,0.39,26,79,0.329,36,80,0.45,0.472,27,36,0.75,23,58,81,17,18,7,18,62,177
2016,Vince Carter,SG,39,MEM,4,4,91,15,33,0.455,7,10,0.7,8,23,0.348,0.561,8,8,1,5,10,15,5,2,1,3,9,45
2016,Ian Clark,SG,24,GSW,16,0,154,26,53,0.491,6,18,0.333,20,35,0.571,0.547,8,10,0.8,2,15,17,16,8,0,9,18,66
2016,Nick Collison,PF,35,OKC,9,0,79,4,6,0.667,0,0,0,4,6,0.667,0.667,1,2,0.5,3,8,11,5,8,0,1,17,9
2016,Pat Connaughton,SG,23,POR,6,0,8,3,5,0.6,2,3,0.667,1,2,0.5,0.8,0,0,0,0,1,1,0,0,0,0,0,8
2016,Allen Crabbe,SG,23,POR,11,0,302,38,73,0.521,15,35,0.429,23,38,0.605,0.623,14,19,0.737,5,27,32,15,7,1,6,23,105
2016,Jamal Crawford,SG,35,LAC,6,1,199,39,103,0.379,4,21,0.19,35,82,0.427,0.398,22,25,0.88,2,11,13,13,10,0,9,9,104
2016,Jae Crowder,SF,25,BOS,6,6,197,20,72,0.278,10,41,0.244,10,31,0.323,0.347,7,11,0.636,5,34,39,13,9,3,7,17,57
2016,Stephen Curry,PG,27,GSW,18,17,614,148,338,0.438,80,198,0.404,68,140,0.486,0.556,76,83,0.916,14,85,99,93,26,5,75,39,452
2016,Troy Daniels,SG,24,CHO,4,0,18,1,8,0.125,0,3,0,1,5,0.2,0.125,0,0,0,0,2,2,0,0,0,0,2,2
2016,Ed Davis,PF,26,POR,11,0,205,21,40,0.525,0,2,0,21,38,0.553,0.525,19,33,0.576,26,49,75,14,2,7,10,33,61
2016,Matthew Dellavedova,PG,25,CLE,20,0,241,26,74,0.351,8,31,0.258,18,43,0.419,0.405,18,24,0.75,4,11,15,56,1,1,14,31,78
2016,Luol Deng,PF,30,MIA,14,14,495,65,138,0.471,24,57,0.421,41,81,0.506,0.558,32,38,0.842,19,64,83,22,13,9,23,24,186
2016,DeMar DeRozan,SG,26,TOR,20,20,746,157,398,0.394,4,26,0.154,153,372,0.411,0.399,100,123,0.813,13,70,83,54,22,3,45,52,418
2016,Boris Diaw,PF,33,SAS,9,0,159,21,46,0.457,2,6,0.333,19,40,0.475,0.478,3,4,0.75,2,17,19,21,2,4,6,9,47
2016,Spencer Dinwiddie,PG,22,DET,1,0,2,1,1,1,0,0,0,1,1,1,1,0,0,0,0,0,0,1,0,0,0,0,2
2016,Goran Dragic,PG,29,MIA,14,14,472,91,206,0.442,16,46,0.348,75,160,0.469,0.481,33,43,0.767,11,58,69,54,6,3,31,46,231
2016,Andre Drummond,C,22,DET,4,4,131,28,54,0.519,0,1,0,28,53,0.528,0.519,11,34,0.324,12,24,36,0,1,6,4,8,67
2016,Tim Duncan,C,39,SAS,10,10,218,22,52,0.423,0,0,0,22,52,0.423,0.423,15,21,0.714,10,38,48,14,2,13,10,18,59
2016,Kevin Durant,SF,27,OKC,18,18,726,175,407,0.43,31,110,0.282,144,297,0.485,0.468,130,146,0.89,13,115,128,60,18,18,65,37,511
2016,Monta Ellis,SG,30,IND,7,7,225,33,76,0.434,7,21,0.333,26,55,0.473,0.48,8,10,0.8,4,23,27,30,15,0,17,17,81
2016,Festus Ezeli,C,26,GSW,23,1,203,37,69,0.536,0,0,0,37,69,0.536,0.536,19,44,0.432,23,38,61,8,1,7,14,34,93
2016,Jordan Farmar,PG,29,MEM,4,4,113,10,31,0.323,4,12,0.333,6,19,0.316,0.387,3,3,1,0,6,6,16,3,1,10,4,27
2016,Raymond Felton,PG,31,DAL,5,4,172,32,69,0.464,4,14,0.286,28,55,0.509,0.493,7,11,0.636,2,21,23,23,6,0,12,14,75
2016,Randy Foye,SG,32,OKC,16,0,190,14,41,0.341,8,26,0.308,6,15,0.4,0.439,4,4,1,2,18,20,13,2,3,11,18,40
2016,Channing Frye,C,32,CLE,17,0,237,41,69,0.594,26,46,0.565,15,23,0.652,0.783,6,7,0.857,5,36,41,5,6,9,5,37,114
2016,Paul George,SF,25,IND,7,7,275,56,123,0.455,18,43,0.419,38,80,0.475,0.528,61,64,0.953,9,44,53,30,14,5,23,24,191
2016,Manu Ginobili,SG,38,SAS,10,0,192,20,47,0.426,9,21,0.429,11,26,0.423,0.521,18,23,0.783,6,21,27,25,8,3,7,25,67
2016,Andrew Goudelock,PG,27,HOU,2,0,11,3,6,0.5,0,1,0,3,5,0.6,0.5,0,0,0,0,2,2,0,0,0,3,0,6
2016,Danny Green,SG,28,SAS,10,10,267,30,65,0.462,24,48,0.5,6,17,0.353,0.646,2,3,0.667,0,31,31,7,21,8,6,20,86
2016,Draymond Green,PF,25,GSW,23,23,879,119,276,0.431,38,104,0.365,81,172,0.471,0.5,79,107,0.738,38,190,228,138,37,41,56,81,355
2016,Gerald Green,SG,30,MIA,12,0,110,16,49,0.327,4,14,0.286,12,35,0.343,0.367,4,5,0.8,2,15,17,1,4,1,2,14,40
2016,JaMychal Green,PF,25,MEM,4,0,72,12,22,0.545,0,1,0,12,21,0.571,0.545,3,6,0.5,5,10,15,3,3,5,4,12,27
2016,Jeff Green,SF,29,LAC,6,1,159,21,46,0.457,4,10,0.4,17,36,0.472,0.5,15,25,0.6,3,16,19,4,6,2,3,12,61
2016,Blake Griffin,PF,26,LAC,4,4,127,20,53,0.377,1,2,0.5,19,51,0.373,0.387,19,25,0.76,7,28,35,16,3,2,9,9,60
2016,Jorge Gutierrez,PG,27,CHO,3,0,12,0,3,0,0,0,0,0,3,0,0,0,0,0,0,2,2,2,0,0,1,0,0
2016,P.J. Hairston,SF,23,MEM,2,0,22,2,6,0.333,1,3,0.333,1,3,0.333,0.417,0,2,0,0,0,0,0,1,0,1,1,5
2016,Tyler Hansbrough,PF,30,CHO,2,0,6,0,0,,0,0,0,0,0,0,,0,0,0,0,0,0,0,0,0,0,0,0
2016,Tim Hardaway,SG,23,ATL,9,0,87,7,26,0.269,2,14,0.143,5,12,0.417,0.308,4,6,0.667,0,9,9,7,0,1,3,2,20
2016,James Harden,SG,26,HOU,5,5,193,41,100,0.41,13,42,0.31,28,58,0.483,0.475,38,45,0.844,7,19,26,38,12,1,26,13,133
2016,Maurice Harkless,SF,22,POR,11,11,272,47,110,0.427,15,44,0.341,32,66,0.485,0.495,12,25,0.48,22,34,56,7,10,3,11,38,121
2016,Montrezl Harrell,PF,22,HOU,2,0,12,1,3,0.333,0,1,0,1,2,0.5,0.333,1,2,0.5,0,2,2,0,0,0,1,1,3
2016,Devin Harris,PG,32,DAL,5,0,121,15,30,0.5,4,13,0.308,11,17,0.647,0.567,5,10,0.5,1,13,14,8,3,0,3,16,39
2016,Tobias Harris,PF,23,DET,4,4,156,21,46,0.457,4,12,0.333,17,34,0.5,0.5,12,13,0.923,6,32,38,12,3,3,6,11,58
2016,Aaron Harrison,SG,21,CHO,2,0,7,0,0,,0,0,0,0,0,0,,0,0,0,0,1,1,0,0,0,0,1,0
2016,Udonis Haslem,PF,35,MIA,9,0,85,8,15,0.533,0,0,0,8,15,0.533,0.533,5,7,0.714,11,20,31,4,0,1,7,13,21
2016,Spencer Hawes,PF,27,CHO,5,0,53,6,13,0.462,1,4,0.25,5,9,0.556,0.5,5,6,0.833,3,13,16,3,1,2,4,5,18
2016,Gerald Henderson,SG,28,POR,11,0,234,30,82,0.366,7,19,0.368,23,63,0.365,0.409,9,12,0.75,6,29,35,17,6,3,5,21,76
2016,George Hill,PG,29,IND,7,7,235,32,57,0.561,13,27,0.481,19,30,0.633,0.675,18,22,0.818,6,13,19,15,6,1,8,16,95
2016,Jordan Hill,C,28,IND,5,0,15,0,3,0,0,0,0,0,3,0,0,0,0,0,2,4,6,2,0,0,0,1,0
2016,Solomon Hill,SF,24,IND,7,0,198,14,31,0.452,11,19,0.579,3,12,0.25,0.629,15,16,0.938,5,23,28,8,2,0,3,20,54
2016,Kirk Hinrich,PG,35,ATL,6,0,27,2,7,0.286,1,3,0.333,1,4,0.25,0.357,0,0,0,0,4,4,3,0,0,0,2,5
2016,John Holland,SF,27,BOS,1,0,1,0,1,0,0,1,0,0,0,0,0,0,0,0,0,0,0,0,0,0,0,0,0
2016,Al Horford,C,29,ATL,10,10,327,54,116,0.466,11,28,0.393,43,88,0.489,0.513,15,16,0.938,13,52,65,30,12,24,17,25,134
2016,Dwight Howard,C,30,HOU,5,5,180,26,48,0.542,0,1,0,26,47,0.553,0.542,14,38,0.368,26,44,70,8,4,7,12,21,66
2016,Josh Huestis,PF,24,OKC,2,0,10,1,3,0.333,1,2,0.5,0,1,0,0.5,0,0,0,1,2,3,0,0,0,0,1,3
2016,Kris Humphries,PF,30,ATL,4,0,56,13,28,0.464,5,10,0.5,8,18,0.444,0.554,6,6,1,8,16,24,4,2,5,2,9,37
2016,R.J. Hunter,SG,22,BOS,5,0,41,2,9,0.222,1,5,0.2,1,4,0.25,0.278,0,0,0,1,5,6,3,0,1,1,3,5
2016,Serge Ibaka,PF,26,OKC,18,18,602,85,163,0.521,31,69,0.449,54,94,0.574,0.617,15,20,0.75,23,90,113,10,14,24,9,51,216
2016,Andre Iguodala,SF,32,GSW,24,3,767,78,164,0.476,25,65,0.385,53,99,0.535,0.552,32,57,0.561,35,70,105,90,29,10,23,37,213
2016,Kyrie Irving,PG,23,CLE,21,21,774,201,423,0.475,51,116,0.44,150,307,0.489,0.535,77,88,0.875,15,47,62,98,36,13,48,46,530
2016,Reggie Jackson,PG,25,DET,4,4,147,25,55,0.455,3,18,0.167,22,37,0.595,0.482,4,4,1,2,11,13,37,6,2,10,10,57
2016,LeBron James,SF,31,CLE,21,21,822,219,417,0.525,32,94,0.34,187,323,0.579,0.564,82,124,0.661,42,158,200,160,49,27,75,54,552
2016,Al Jefferson,C,31,CHO,7,5,168,42,83,0.506,0,0,0,42,83,0.506,0.506,9,13,0.692,14,29,43,8,4,3,6,12,93
2016,Richard Jefferson,SF,35,CLE,21,2,381,44,84,0.524,11,28,0.393,33,56,0.589,0.589,15,20,0.75,16,58,74,14,10,1,13,34,114
2016,Jonas Jerebko,PF,28,BOS,6,4,162,22,46,0.478,7,22,0.318,15,24,0.625,0.554,4,5,0.8,7,34,41,10,2,4,5,15,55
2016,Amir Johnson,PF,28,BOS,6,6,134,22,33,0.667,0,2,0,22,31,0.71,0.667,7,9,0.778,11,32,43,4,1,8,10,13,51
2016,James Johnson,PF,28,TOR,10,0,98,12,25,0.48,4,9,0.444,8,16,0.5,0.56,2,3,0.667,3,12,15,6,3,0,7,13,30
2016,Joe Johnson,SF,34,MIA,14,14,492,68,158,0.43,13,46,0.283,55,112,0.491,0.472,21,24,0.875,7,59,66,35,8,3,18,27,170
2016,Stanley Johnson,SF,19,DET,4,0,81,12,23,0.522,6,10,0.6,6,13,0.462,0.652,2,2,1,0,16,16,0,1,0,3,10,32
2016,Tyler Johnson,SG,23,MIA,5,0,61,5,11,0.455,3,6,0.5,2,5,0.4,0.591,8,11,0.727,2,5,7,8,1,0,2,8,21
2016,Wesley Johnson,SF,28,LAC,6,0,77,5,14,0.357,3,9,0.333,2,5,0.4,0.464,3,3,1,5,13,18,2,1,4,2,6,16
2016,Dahntay Jones,SF,35,CLE,15,0,50,6,13,0.462,1,3,0.333,5,10,0.5,0.5,4,5,0.8,0,7,7,2,1,1,1,3,17
2016,James Jones,SF,35,CLE,12,0,55,2,10,0.2,1,7,0.143,1,3,0.333,0.25,1,4,0.25,1,3,4,3,0,0,1,3,6
2016,DeAndre Jordan,C,27,LAC,6,6,198,24,38,0.632,0,0,0,24,38,0.632,0.632,22,59,0.373,30,68,98,11,7,16,7,17,70
2016,Cory Joseph,SG,24,TOR,20,0,452,69,148,0.466,8,24,0.333,61,124,0.492,0.493,24,32,0.75,11,30,41,47,18,2,22,47,170
2016,Chris Kaman,C,33,POR,4,0,32,7,18,0.389,0,0,0,7,18,0.389,0.389,0,0,0,2,6,8,1,2,0,6,10,14
2016,Frank Kaminsky,C,22,CHO,7,5,190,14,46,0.304,5,17,0.294,9,29,0.31,0.359,17,21,0.81,3,27,30,8,6,5,2,15,50
2016,Enes Kanter,C,23,OKC,18,0,323,65,118,0.551,2,14,0.143,63,104,0.606,0.559,38,45,0.844,47,64,111,5,5,11,17,40,170
2016,Kyle Korver,SG,34,ATL,10,8,316,35,75,0.467,24,54,0.444,11,21,0.524,0.627,9,9,1,3,45,48,10,9,4,8,23,103
2016,Jeremy Lamb,SG,23,CHO,3,0,12,5,9,0.556,1,1,1,4,8,0.5,0.611,0,0,0,1,3,4,1,0,0,0,0,11
2016,Ty Lawson,PG,28,IND,7,0,74,6,18,0.333,0,3,0,6,15,0.4,0.333,4,6,0.667,1,6,7,10,3,0,6,8,16
2016,Courtney Lee,SG,30,CHO,7,7,257,21,51,0.412,4,9,0.444,17,42,0.405,0.451,14,15,0.933,5,15,20,9,6,3,5,19,60
2016,David Lee,PF,32,DAL,2,0,33,6,8,0.75,0,0,0,6,8,0.75,0.75,0,0,0,1,5,6,1,0,0,0,7,12
2016,Kawhi Leonard,SF,24,SAS,10,10,339,83,166,0.5,17,39,0.436,66,127,0.52,0.551,42,51,0.824,14,49,63,28,26,14,16,21,225
2016,Damian Lillard,PG,25,POR,11,11,437,89,242,0.368,42,107,0.393,47,135,0.348,0.455,71,78,0.91,12,35,47,69,14,3,33,23,291
2016,Jeremy Lin,SG,27,CHO,7,0,189,26,63,0.413,3,14,0.214,23,49,0.469,0.437,32,39,0.821,3,13,16,18,5,0,11,21,87
2016,Shaun Livingston,PG,30,GSW,24,7,514,82,168,0.488,0,1,0,82,167,0.491,0.488,32,37,0.865,13,63,76,80,12,5,29,48,196
2016,Kevin Love,PF,27,CLE,20,19,613,92,239,0.385,46,111,0.414,46,128,0.359,0.481,63,75,0.84,34,141,175,42,9,8,27,34,293
2016,Kyle Lowry,PG,29,TOR,20,20,766,131,330,0.397,42,138,0.304,89,192,0.464,0.461,78,104,0.75,18,76,94,119,32,3,63,73,382
2016,Ian Mahinmi,C,29,IND,7,7,172,21,42,0.5,0,0,0,21,42,0.5,0.5,15,25,0.6,12,24,36,8,5,6,14,25,57
2016,Boban Marjanovic,C,27,SAS,7,0,42,8,12,0.667,0,0,0,8,12,0.667,0.667,8,9,0.889,4,10,14,3,0,2,3,10,24
2016,Jarell Martin,PF,21,MEM,2,0,46,3,8,0.375,0,0,0,3,8,0.375,0.375,3,6,0.5,4,3,7,1,3,0,3,4,9
2016,Kevin Martin,SG,32,SAS,5,0,49,8,20,0.4,4,8,0.5,4,12,0.333,0.5,2,3,0.667,0,4,4,3,1,0,6,5,22
2016,Wesley Matthews,SF,29,DAL,5,5,173,20,60,0.333,10,35,0.286,10,25,0.4,0.417,15,19,0.789,4,14,18,6,6,0,4,14,65
2016,Luc Mbah a Moute,PF,29,LAC,5,5,78,4,6,0.667,0,0,0,4,6,0.667,0.667,1,1,1,2,8,10,1,3,0,2,9,9
2016,James Michael McAdoo,PF,23,GSW,8,0,38,2,4,0.5,0,0,0,2,4,0.5,0.5,1,4,0.25,0,8,8,2,3,2,1,6,5
2016,CJ McCollum,SG,24,POR,11,11,442,84,197,0.426,20,58,0.345,64,139,0.46,0.477,37,46,0.804,7,33,40,36,10,5,20,30,225
2016,K.J. McDaniels,SF,22,HOU,4,0,34,4,13,0.308,1,3,0.333,3,10,0.3,0.346,0,0,0,1,6,7,1,0,3,0,3,9
2016,JaVale McGee,C,28,DAL,2,0,14,1,2,0.5,0,0,0,1,2,0.5,0.5,2,6,0.333,2,1,3,0,1,0,3,3,4
2016,Jordan McRae,PG,24,CLE,2,0,4,4,4,1,1,1,1,3,3,1,1.125,0,0,0,0,2,2,0,0,0,0,0,9
2016,Josh McRoberts,PF,28,MIA,10,0,134,16,34,0.471,0,7,0,16,27,0.593,0.471,6,6,1,7,19,26,9,5,5,4,20,38
2016,Jodie Meeks,SG,28,DET,1,0,2,1,1,1,0,0,0,1,1,1,1,0,0,0,0,0,0,0,0,0,0,0,2
2016,Salah Mejri,C,29,DAL,4,1,76,7,10,0.7,0,0,0,7,10,0.7,0.7,5,12,0.417,5,8,13,1,3,5,0,11,19
2016,Jordan Mickey,PF,21,BOS,2,0,10,2,4,0.5,0,0,0,2,4,0.5,0.5,0,0,0,1,1,2,2,0,1,0,0,4
2016,C.J. Miles,SF,28,IND,7,0,92,10,38,0.263,2,20,0.1,8,18,0.444,0.289,2,3,0.667,4,20,24,4,1,1,3,7,24
2016,Andre Miller,PG,39,SAS,5,0,35,3,7,0.429,1,3,0.333,2,4,0.5,0.5,2,2,1,2,3,5,7,0,0,0,4,9
2016,Patty Mills,PG,27,SAS,10,0,167,23,53,0.434,13,36,0.361,10,17,0.588,0.557,7,11,0.636,0,14,14,20,7,0,8,3,66
2016,Paul Millsap,PF,30,ATL,10,10,365,59,137,0.431,8,33,0.242,51,104,0.49,0.46,41,55,0.745,28,66,94,27,13,23,26,29,167
2016,Nazr Mohammed,C,38,OKC,5,0,10,1,2,0.5,0,0,0,1,2,0.5,0.5,0,0,0,1,2,3,0,0,1,1,1,2
2016,Luis Montero,SG,22,POR,6,0,8,3,3,1,2,2,1,1,1,1,1.333,0,0,0,0,0,0,0,0,0,0,1,8
2016,Marcus Morris,SF,26,DET,4,4,144,22,47,0.468,7,18,0.389,15,29,0.517,0.543,20,23,0.87,2,11,13,10,2,0,5,17,71
2016,Anthony Morrow,SG,30,OKC,14,0,76,11,24,0.458,5,14,0.357,6,10,0.6,0.563,10,10,1,0,2,2,1,1,0,4,5,37
2016,Donatas Motiejunas,PF,25,HOU,5,4,98,16,37,0.432,4,9,0.444,12,28,0.429,0.486,8,17,0.471,10,16,26,5,4,2,12,11,44
2016,Timofey Mozgov,C,29,CLE,13,0,76,6,15,0.4,0,0,0,6,15,0.4,0.4,3,4,0.75,5,16,21,2,3,3,8,16,15
2016,Xavier Munford,SG,23,MEM,4,0,89,9,28,0.321,1,8,0.125,8,20,0.4,0.339,0,2,0,1,8,9,10,6,3,5,8,19
2016,Mike Muscala,C,24,ATL,9,0,67,10,20,0.5,2,6,0.333,8,14,0.571,0.55,2,2,1,7,10,17,3,0,1,3,6,24
2016,Lucas Nogueira,C,23,TOR,5,0,29,3,4,0.75,0,0,0,3,4,0.75,0.75,0,0,0,1,7,8,0,0,0,0,3,6
2016,Dirk Nowitzki,PF,37,DAL,5,5,170,41,83,0.494,4,11,0.364,37,72,0.514,0.518,16,17,0.941,3,21,24,8,2,3,7,9,102
2016,Kelly Olynyk,C,24,BOS,4,0,32,1,9,0.111,0,3,0,1,6,0.167,0.111,0,0,0,2,2,4,3,1,0,4,5,2
2016,Zaza Pachulia,C,31,DAL,5,4,112,9,24,0.375,0,0,0,9,24,0.375,0.375,15,17,0.882,10,17,27,16,3,1,2,13,33
2016,Tony Parker,PG,33,SAS,10,10,264,44,98,0.449,4,16,0.25,40,82,0.488,0.469,12,14,0.857,1,21,22,53,6,2,18,15,104
2016,Lamar Patterson,SG,24,ATL,4,0,20,2,7,0.286,1,3,0.333,1,4,0.25,0.357,1,1,1,0,5,5,3,1,0,4,1,6
2016,Patrick Patterson,PF,26,TOR,20,9,583,55,136,0.404,21,70,0.3,34,66,0.515,0.482,22,26,0.846,29,48,77,24,7,9,18,31,153
2016,Chris Paul,PG,30,LAC,4,4,125,37,76,0.487,6,20,0.3,31,56,0.554,0.526,15,15,1,4,12,16,29,9,0,4,12,95
2016,Cameron Payne,PG,21,OKC,10,0,64,7,26,0.269,2,10,0.2,5,16,0.313,0.308,2,4,0.5,0,4,4,8,2,2,8,7,18
2016,Paul Pierce,SF,38,LAC,5,1,54,2,12,0.167,1,5,0.2,1,7,0.143,0.208,1,4,0.25,0,6,6,1,2,0,2,6,6
2016,Mason Plumlee,C,25,POR,11,11,306,28,70,0.4,0,0,0,28,70,0.4,0.4,21,33,0.636,37,93,130,53,7,11,25,42,77
2016,Dwight Powell,PF,24,DAL,4,0,64,9,19,0.474,0,1,0,9,18,0.5,0.474,6,11,0.545,9,8,17,4,1,0,1,5,24
2016,Norman Powell,SG,22,TOR,18,3,206,27,70,0.386,7,26,0.269,20,44,0.455,0.436,7,8,0.875,4,23,27,6,13,2,5,18,68
2016,Pablo Prigioni,PG,38,LAC,5,0,26,0,5,0,0,2,0,0,3,0,0,0,0,0,2,1,3,7,0,0,3,8,0
2016,Zach Randolph,PF,34,MEM,4,4,120,23,62,0.371,0,0,0,23,62,0.371,0.371,6,7,0.857,15,20,35,7,1,0,7,10,52
2016,J.J. Redick,SG,31,LAC,6,6,166,34,79,0.43,11,31,0.355,23,48,0.479,0.5,2,3,0.667,1,11,12,5,1,1,5,11,81
2016,Josh Richardson,SG,22,MIA,14,0,387,33,89,0.371,17,46,0.37,16,43,0.372,0.466,10,14,0.714,10,40,50,22,6,13,12,37,93
2016,Austin Rivers,SG,23,LAC,6,2,144,26,61,0.426,4,17,0.235,22,44,0.5,0.459,6,9,0.667,4,12,16,16,3,0,7,12,62
2016,Andre Roberson,SG,24,OKC,18,18,471,40,86,0.465,12,37,0.324,28,49,0.571,0.535,8,20,0.4,25,76,101,14,23,19,11,45,100
2016,Brian Roberts,PG,30,POR,10,0,36,2,9,0.222,0,4,0,2,5,0.4,0.222,4,6,0.667,1,0,1,3,0,0,1,5,8
2016,Glenn Robinson,SF,22,IND,4,0,10,3,4,0.75,0,0,0,3,4,0.75,0.75,1,1,1,0,0,0,0,0,1,0,0,7
2016,Terrence Ross,SF,24,TOR,20,0,335,46,119,0.387,21,64,0.328,25,55,0.455,0.475,13,20,0.65,4,28,32,11,13,5,16,28,126
2016,Terry Rozier,PG,21,BOS,5,0,99,9,23,0.391,4,11,0.364,5,12,0.417,0.478,2,2,1,3,14,17,6,1,3,2,5,24
2016,Brandon Rush,SG,30,GSW,14,0,110,9,20,0.45,4,12,0.333,5,8,0.625,0.55,1,2,0.5,0,23,23,3,2,2,2,9,23
2016,Dennis Schroder,PG,22,ATL,10,0,191,47,104,0.452,12,35,0.343,35,69,0.507,0.51,11,13,0.846,6,13,19,36,4,1,21,24,117
2016,Luis Scola,PF,35,TOR,11,9,140,8,31,0.258,4,21,0.19,4,10,0.4,0.323,8,11,0.727,2,16,18,7,3,0,5,22,28
2016,Mike Scott,PF,27,ATL,10,0,161,25,40,0.625,8,16,0.5,17,24,0.708,0.725,7,8,0.875,5,27,32,5,3,3,8,20,65
2016,Thabo Sefolosha,SF,31,ATL,10,2,203,22,46,0.478,7,19,0.368,15,27,0.556,0.554,8,15,0.533,8,33,41,17,10,6,10,17,59
2016,Iman Shumpert,SG,25,CLE,21,0,367,25,60,0.417,13,34,0.382,12,26,0.462,0.525,7,11,0.636,10,37,47,17,10,3,13,36,70
2016,Jonathon Simmons,SG,26,SAS,3,0,26,4,10,0.4,2,3,0.667,2,7,0.286,0.5,1,2,0.5,3,1,4,2,2,0,1,4,11
2016,Kyle Singler,SF,27,OKC,6,0,51,3,9,0.333,2,4,0.5,1,5,0.2,0.444,0,2,0,1,6,7,0,1,0,0,4,8
2016,Marcus Smart,PG,21,BOS,6,1,193,22,60,0.367,11,32,0.344,11,28,0.393,0.458,17,21,0.81,8,19,27,18,10,5,15,17,72
2016,J.R. Smith,SG,30,CLE,21,21,730,82,188,0.436,65,151,0.43,17,37,0.459,0.609,13,21,0.619,7,60,67,29,26,5,11,55,242
2016,Josh Smith,PF,30,HOU,4,0,38,6,13,0.462,4,8,0.5,2,5,0.4,0.615,0,2,0,1,1,2,4,1,1,5,7,16
2016,Marreese Speights,C,28,GSW,24,0,201,46,118,0.39,18,43,0.419,28,75,0.373,0.466,24,31,0.774,15,32,47,11,3,8,20,43,134
2016,Lance Stephenson,SF,25,MEM,4,0,95,23,44,0.523,2,5,0.4,21,39,0.538,0.545,4,5,0.8,1,5,6,7,1,0,3,10,52
2016,Amar'e Stoudemire,C,33,MIA,9,2,82,11,19,0.579,0,0,0,11,19,0.579,0.579,8,8,1,3,10,13,0,5,3,9,14,30
2016,Rodney Stuckey,PG,29,IND,7,0,125,17,43,0.395,5,10,0.5,12,33,0.364,0.453,5,9,0.556,1,14,15,14,4,1,6,9,44
2016,Jared Sullinger,PF,23,BOS,6,2,81,13,42,0.31,2,4,0.5,11,38,0.289,0.333,3,4,0.75,10,17,27,7,1,0,6,16,31
2016,Jeff Teague,PG,27,ATL,10,10,279,46,121,0.38,9,36,0.25,37,85,0.435,0.417,44,52,0.846,3,16,19,62,6,2,25,30,145
2016,Jason Terry,SG,38,HOU,5,0,124,13,38,0.342,6,19,0.316,7,19,0.368,0.421,3,3,1,1,10,11,6,2,1,3,13,35
2016,Isaiah Thomas,PG,26,BOS,6,6,220,47,119,0.395,13,46,0.283,34,73,0.466,0.45,38,47,0.809,2,16,18,30,4,5,14,18,145
2016,Jason Thompson,C,29,TOR,10,0,55,4,9,0.444,0,1,0,4,8,0.5,0.444,0,3,0,6,5,11,1,0,1,1,6,8
2016,Klay Thompson,SG,25,GSW,24,24,849,201,453,0.444,98,231,0.424,103,222,0.464,0.552,82,96,0.854,15,73,88,54,26,9,47,53,582
2016,Tristan Thompson,PF,24,CLE,21,21,622,49,93,0.527,0,0,0,49,93,0.527,0.527,42,73,0.575,86,102,188,15,8,18,17,55,140
2016,Anthony Tolliver,PF,30,DET,3,0,26,2,4,0.5,0,2,0,2,2,1,0.5,0,0,0,1,3,4,1,0,1,0,0,4
2016,Evan Turner,SG,27,BOS,6,4,214,31,85,0.365,3,14,0.214,28,71,0.394,0.382,14,18,0.778,8,26,34,27,8,6,17,19,79
2016,Myles Turner,C,19,IND,7,4,197,33,71,0.465,0,2,0,33,69,0.478,0.465,6,9,0.667,16,29,45,3,2,23,12,24,72
2016,Jonas Valanciunas,C,23,TOR,12,10,321,68,120,0.567,0,0,0,68,120,0.567,0.567,29,39,0.744,48,81,129,11,10,14,18,32,165
2016,Anderson Varejao,C,33,GSW,17,0,93,5,14,0.357,0,0,0,5,14,0.357,0.357,10,19,0.526,12,9,21,13,2,2,2,17,20
2016,Charlie Villanueva,PF,31,DAL,4,0,20,3,12,0.25,1,5,0.2,2,7,0.286,0.292,2,2,1,0,2,2,1,0,0,1,2,9
2016,Noah Vonleh,PF,20,POR,6,0,12,0,3,0,0,0,0,0,3,0,0,0,0,0,1,3,4,2,2,0,0,1,0
2016,Dwyane Wade,SG,34,MIA,14,14,473,119,254,0.469,12,23,0.522,107,231,0.463,0.492,50,64,0.781,12,67,79,60,11,13,38,22,300
2016,Dion Waiters,SG,24,OKC,18,0,491,55,132,0.417,21,56,0.375,34,76,0.447,0.496,20,30,0.667,6,41,47,42,10,3,20,42,151
2016,Kemba Walker,PG,25,CHO,7,7,260,56,153,0.366,14,43,0.326,42,110,0.382,0.412,33,35,0.943,3,18,21,28,9,4,12,10,159
2016,Briante Weber,PG,23,MIA,2,0,6,0,1,0,0,0,0,0,1,0,0,0,0,0,0,0,0,1,1,0,0,1,0
2016,David West,PF,35,SAS,10,0,176,25,55,0.455,3,6,0.5,22,49,0.449,0.482,5,9,0.556,13,24,37,13,6,7,7,19,58
2016,Russell Westbrook,PG,27,OKC,18,18,674,159,393,0.405,34,105,0.324,125,288,0.434,0.448,116,140,0.829,41,83,124,198,46,2,78,43,468
2016,Hassan Whiteside,C,26,MIA,10,10,291,47,69,0.681,0,0,0,47,69,0.681,0.681,26,44,0.591,26,83,109,3,8,28,13,34,120
2016,C.J. Wilcox,SG,25,LAC,2,0,7,0,1,0,0,0,0,0,1,0,0,0,0,0,0,1,1,1,0,0,0,1,0
2016,Deron Williams,PG,31,DAL,3,3,49,6,18,0.333,3,7,0.429,3,11,0.273,0.417,0,0,0,0,2,2,8,1,0,7,6,15
2016,Marvin Williams,PF,29,CHO,7,7,228,14,51,0.275,6,17,0.353,8,34,0.235,0.333,2,4,0.5,7,41,48,6,6,3,2,11,36
2016,Mo Williams,PG,33,CLE,13,0,68,8,28,0.286,3,13,0.231,5,15,0.333,0.339,1,2,0.5,0,6,6,3,4,0,10,8,20
2016,Justise Winslow,SF,19,MIA,13,2,330,32,74,0.432,5,18,0.278,27,56,0.482,0.466,21,30,0.7,17,46,63,8,8,4,12,35,90
2016,Delon Wright,PG,23,TOR,9,0,41,3,10,0.3,0,1,0,3,9,0.333,0.3,8,13,0.615,1,3,4,3,3,0,2,2,14
2016,Dorell Wright,SF,30,MIA,5,0,19,5,10,0.5,2,5,0.4,3,5,0.6,0.6,4,4,1,0,6,6,2,0,0,0,2,16
2016,James Young,SG,20,BOS,3,0,10,1,3,0.333,0,1,0,1,2,0.5,0.333,0,0,0,0,0,0,0,0,0,1,1,2
2016,Joe Young,PG,23,IND,4,0,10,3,8,0.375,1,4,0.25,2,4,0.5,0.438,2,2,1,0,1,1,1,0,0,2,3,9
2016,Cody Zeller,C,23,CHO,7,2,137,21,38,0.553,0,0,0,21,38,0.553,0.553,17,21,0.81,9,28,37,2,1,3,7,20,59
2016,Tyler Zeller,C,26,BOS,3,0,38,7,15,0.467,0,0,0,7,15,0.467,0.467,4,6,0.667,4,11,15,2,0,2,2,1,18
2017,Alex Abrines,SG,23,OKC,5,0,80,8,23,0.348,5,17,0.294,3,6,0.5,0.457,3,4,0.75,2,7,9,4,0,0,0,8,24
2017,Steven Adams,C,23,OKC,5,5,157,18,28,0.643,0,0,0,18,28,0.643,0.643,4,11,0.364,17,17,34,7,6,9,4,14,40
2017,LaMarcus Aldridge,PF,31,SAS,16,16,537,110,240,0.458,2,14,0.143,108,226,0.478,0.463,42,55,0.764,43,76,119,24,10,16,28,41,264
2017,Lavoy Allen,PF,27,IND,3,0,11,0,0,,0,0,0,0,0,0,,0,0,0,0,2,2,0,0,0,1,0,0
2017,Al-Farouq Aminu,PF,26,POR,4,0,113,17,37,0.459,7,17,0.412,10,20,0.5,0.554,7,11,0.636,5,21,26,4,3,4,9,9,48
2017,Kyle Anderson,SF,23,SAS,15,1,195,36,64,0.563,3,10,0.3,33,54,0.611,0.586,8,11,0.727,12,34,46,25,10,2,7,8,83
2017,Ryan Anderson,PF,28,HOU,11,9,336,36,92,0.391,17,60,0.283,19,32,0.594,0.484,14,16,0.875,15,42,57,7,4,2,9,24,103
2017,Giannis Antetokounmpo,SF,22,MIL,6,6,243,60,112,0.536,4,10,0.4,56,102,0.549,0.554,25,46,0.543,10,47,57,24,13,10,20,21,149
2017,Joel Anthony,C,34,SAS,3,0,15,3,4,0.75,0,0,0,3,4,0.75,0.75,0,1,0,2,2,4,0,0,2,1,2,6
2017,Trevor Ariza,SF,31,HOU,11,11,413,41,97,0.423,23,61,0.377,18,36,0.5,0.541,13,14,0.929,8,48,56,23,14,2,9,25,118
2017,Wade Baldwin,PG,20,MEM,3,0,12,0,1,0,0,0,0,0,1,0,0,2,2,1,1,3,4,2,0,0,0,3,2
2017,Matt Barnes,SF,36,GSW,12,0,61,4,15,0.267,1,8,0.125,3,7,0.429,0.3,0,0,0,0,9,9,7,2,0,3,9,9
2017,Brandon Bass,PF,31,LAC,1,0,4,1,3,0.333,0,0,0,1,3,0.333,0.333,0,0,0,1,0,1,0,1,0,0,0,2
2017,Kent Bazemore,SF,27,ATL,6,0,150,21,53,0.396,7,24,0.292,14,29,0.483,0.462,10,14,0.714,4,19,23,20,4,5,16,15,59
2017,Bradley Beal,SG,23,WAS,13,13,505,122,259,0.471,29,101,0.287,93,158,0.589,0.527,50,61,0.82,15,29,44,35,21,8,27,38,323
2017,Michael Beasley,PF,28,MIL,4,0,48,7,20,0.35,3,5,0.6,4,15,0.267,0.425,0,4,0,2,7,9,1,1,1,2,8,17
2017,Davis Bertans,PF,24,SAS,13,0,112,12,27,0.444,8,20,0.4,4,7,0.571,0.593,4,6,0.667,5,15,20,3,3,4,6,7,36
2017,Patrick Beverley,SG,28,HOU,11,11,325,45,109,0.413,21,52,0.404,24,57,0.421,0.509,11,14,0.786,21,40,61,33,16,2,18,38,122
2017,Bojan Bogdanovic,SF,27,WAS,13,0,264,36,87,0.414,16,45,0.356,20,42,0.476,0.506,27,32,0.844,10,46,56,9,6,1,8,17,115
2017,Joel Bolomboy,PF,23,UTA,2,0,9,2,3,0.667,0,0,0,2,3,0.667,0.667,0,0,0,0,2,2,0,0,1,0,0,4
2017,Avery Bradley,SG,26,BOS,18,18,645,120,272,0.441,40,114,0.351,80,158,0.506,0.515,21,27,0.778,18,53,71,41,23,3,31,40,301
2017,Malcolm Brogdon,SG,24,MIL,6,6,183,22,55,0.4,10,21,0.476,12,34,0.353,0.491,0,0,0,3,23,26,21,3,2,12,12,54
2017,Aaron Brooks,PG,32,IND,1,0,7,2,3,0.667,1,2,0.5,1,1,1,0.833,0,0,0,0,1,1,1,0,0,1,0,5
2017,Bobby Brown,PG,32,HOU,5,0,22,10,20,0.5,5,11,0.455,5,9,0.556,0.625,0,0,0,0,2,2,1,0,0,0,1,25
2017,Jaylen Brown,SF,20,BOS,17,0,215,34,71,0.479,5,23,0.217,29,48,0.604,0.514,12,18,0.667,12,24,36,13,6,2,13,26,85
2017,Trey Burke,PG,24,WAS,3,0,20,0,4,0,0,2,0,0,2,0,0,0,0,0,0,0,0,5,0,0,0,2,0
2017,Jimmy Butler,SF,27,CHI,6,6,239,46,108,0.426,6,23,0.261,40,85,0.471,0.454,38,47,0.809,9,35,44,26,10,5,15,10,136
2017,Jose Calderon,PG,35,ATL,6,0,75,11,23,0.478,4,12,0.333,7,11,0.636,0.565,0,0,0,2,6,8,13,2,1,4,9,26
2017,Isaiah Canaan,SG,25,CHI,3,2,95,13,26,0.5,5,14,0.357,8,12,0.667,0.596,4,6,0.667,0,4,4,4,3,0,5,6,35
2017,Clint Capela,C,22,HOU,11,11,286,46,82,0.561,0,1,0,46,81,0.568,0.561,24,39,0.615,26,70,96,12,8,28,8,28,116
2017,DeMarre Carroll,SF,30,TOR,10,7,155,15,37,0.405,7,22,0.318,8,15,0.533,0.5,5,9,0.556,4,23,27,5,8,5,5,13,42
2017,Vince Carter,SF,40,MEM,6,6,195,20,42,0.476,8,20,0.4,12,22,0.545,0.571,7,7,1,4,16,20,9,2,0,10,15,55
2017,Michael Carter-Williams,PG,25,CHI,5,0,53,6,15,0.4,0,1,0,6,14,0.429,0.4,2,4,0.5,1,3,4,6,2,1,6,6,14
2017,Semaj Christon,PG,24,OKC,2,0,21,2,5,0.4,1,3,0.333,1,2,0.5,0.5,0,0,0,0,3,3,5,1,0,0,1,5
2017,Ian Clark,SG,25,GSW,16,0,219,40,79,0.506,13,36,0.361,27,43,0.628,0.589,16,17,0.941,4,22,26,11,6,0,11,17,109
2017,Norris Cole,PG,28,OKC,4,0,25,2,8,0.25,1,4,0.25,1,4,0.25,0.313,0,0,0,0,1,1,1,0,1,2,4,5
2017,Mike Conley,PG,29,MEM,6,6,224,50,103,0.485,17,38,0.447,33,65,0.508,0.568,31,37,0.838,1,19,20,42,10,3,12,11,148
2017,Pat Connaughton,SG,24,POR,3,0,24,2,9,0.222,0,6,0,2,3,0.667,0.222,3,3,1,1,6,7,4,0,0,0,0,7
2017,Allen Crabbe,SG,24,POR,4,0,92,9,24,0.375,3,13,0.231,6,11,0.545,0.438,1,3,0.333,0,12,12,2,1,0,1,9,22
2017,Jamal Crawford,SG,36,LAC,7,0,196,35,83,0.422,6,25,0.24,29,58,0.5,0.458,12,12,1,2,7,9,13,4,1,9,12,88
2017,Jae Crowder,SF,26,BOS,18,18,596,87,200,0.435,31,88,0.352,56,112,0.5,0.513,40,48,0.833,20,95,115,48,19,6,12,52,245
2017,Stephen Curry,PG,28,GSW,17,17,601,151,312,0.484,72,172,0.419,79,140,0.564,0.599,103,114,0.904,22,84,106,114,34,4,58,37,477
2017,Troy Daniels,SG,25,MEM,6,0,68,3,9,0.333,3,9,0.333,0,0,0,0.5,0,0,0,1,4,5,2,2,0,2,1,9
2017,Deyonta Davis,C,20,MEM,3,0,11,3,5,0.6,0,0,0,3,5,0.6,0.6,1,2,0.5,2,3,5,0,0,0,0,2,7
2017,Dewayne Dedmon,C,27,SAS,12,3,97,14,23,0.609,0,0,0,14,23,0.609,0.609,17,32,0.531,21,26,47,3,2,3,8,16,45
2017,Sam Dekker,PF,22,HOU,4,0,31,3,12,0.25,3,6,0.5,0,6,0,0.375,0,0,0,5,5,10,1,1,1,0,2,9
2017,Malcolm Delaney,PG,27,ATL,1,0,3,3,3,1,1,1,1,2,2,1,1.167,1,2,0.5,0,1,1,0,0,0,0,0,8
2017,Matthew Dellavedova,PG,26,MIL,6,0,159,16,41,0.39,6,16,0.375,10,25,0.4,0.463,8,10,0.8,1,11,12,12,1,0,7,5,46
2017,DeMar DeRozan,SG,27,TOR,10,10,373,76,175,0.434,1,15,0.067,75,160,0.469,0.437,71,80,0.888,4,45,49,34,14,0,25,26,224
2017,Boris Diaw,PF,34,UTA,11,9,203,24,48,0.5,6,14,0.429,18,34,0.529,0.563,9,10,0.9,3,18,21,22,7,4,14,12,63
2017,Mike Dunleavy,SF,36,ATL,6,0,53,3,7,0.429,2,5,0.4,1,2,0.5,0.571,4,4,1,1,4,5,2,1,0,6,3,12
2017,Kevin Durant,PF,28,GSW,15,15,533,149,268,0.556,38,86,0.442,111,182,0.61,0.627,92,103,0.893,16,103,119,64,12,20,38,39,428
2017,Monta Ellis,SG,31,IND,4,2,76,8,20,0.4,2,8,0.25,6,12,0.5,0.45,4,5,0.8,1,7,8,5,2,1,4,5,22
2017,James Ennis,SF,26,MEM,6,4,159,16,38,0.421,6,19,0.316,10,19,0.526,0.5,12,14,0.857,8,17,25,7,5,2,7,20,50
2017,Dante Exum,PG,21,UTA,7,0,84,11,27,0.407,4,12,0.333,7,15,0.467,0.481,6,6,1,2,4,6,9,5,0,3,10,32
2017,Derrick Favors,PF,25,UTA,11,2,225,36,62,0.581,0,0,0,36,62,0.581,0.581,11,23,0.478,15,45,60,10,8,6,4,25,83
2017,Cristiano Felicio,C,24,CHI,6,0,82,9,15,0.6,0,0,0,9,15,0.6,0.6,1,2,0.5,7,19,26,2,3,2,7,16,19
2017,Raymond Felton,PG,32,LAC,7,0,127,15,32,0.469,4,9,0.444,11,23,0.478,0.531,5,5,1,2,8,10,10,6,0,3,10,39
2017,Bryn Forbes,SG,23,SAS,6,0,73,6,21,0.286,2,9,0.222,4,12,0.333,0.333,6,6,1,0,6,6,3,0,1,2,5,20
2017,Channing Frye,C,33,CLE,12,0,154,31,60,0.517,20,39,0.513,11,21,0.524,0.683,6,7,0.857,0,22,22,13,3,4,2,11,88
2017,Marc Gasol,C,32,MEM,6,6,240,39,83,0.47,7,12,0.583,32,71,0.451,0.512,31,33,0.939,7,32,39,25,2,4,15,22,116
2017,Pau Gasol,C,36,SAS,16,7,365,50,114,0.439,6,18,0.333,44,96,0.458,0.465,17,24,0.708,39,75,114,31,7,15,18,35,123
2017,Paul George,SF,26,IND,4,4,172,34,88,0.386,18,42,0.429,16,46,0.348,0.489,26,30,0.867,5,30,35,29,7,2,13,13,112
2017,Taj Gibson,PF,31,OKC,5,5,118,21,35,0.6,0,0,0,21,35,0.6,0.6,7,8,0.875,3,15,18,3,1,0,8,13,49
2017,Manu Ginobili,SG,39,SAS,16,1,284,40,97,0.412,9,40,0.225,31,57,0.544,0.459,17,23,0.739,10,29,39,39,16,2,12,28,106
2017,Rudy Gobert,C,24,UTA,9,9,246,40,63,0.635,0,0,0,40,63,0.635,0.635,24,50,0.48,22,67,89,11,9,12,9,30,104
2017,Eric Gordon,SG,28,HOU,11,2,358,51,121,0.421,27,70,0.386,24,51,0.471,0.533,13,18,0.722,5,38,43,22,8,6,14,20,142
2017,Marcin Gortat,C,32,WAS,13,13,409,47,93,0.505,0,0,0,47,93,0.505,0.505,11,18,0.611,52,91,143,24,5,20,17,40,105
2017,Jerami Grant,PF,22,OKC,5,0,111,19,31,0.613,2,6,0.333,17,25,0.68,0.645,6,7,0.857,7,12,19,4,1,2,3,7,46
2017,Jerian Grant,PG,24,CHI,5,2,52,6,23,0.261,1,9,0.111,5,14,0.357,0.283,3,3,1,0,4,4,5,2,0,7,3,16
2017,Danny Green,SG,29,SAS,16,16,436,45,111,0.405,26,76,0.342,19,35,0.543,0.523,8,14,0.571,13,44,57,23,10,15,17,30,124
2017,Draymond Green,PF,26,GSW,17,17,593,72,161,0.447,32,78,0.41,40,83,0.482,0.547,46,67,0.687,20,135,155,110,31,28,36,60,222
2017,Gerald Green,SF,31,BOS,13,7,192,34,72,0.472,21,45,0.467,13,27,0.481,0.618,8,9,0.889,2,18,20,9,3,1,7,21,97
2017,JaMychal Green,PF,26,MEM,6,2,118,17,36,0.472,7,16,0.438,10,20,0.5,0.569,3,3,1,3,17,20,2,0,0,4,21,44
2017,Blake Griffin,PF,27,LAC,3,3,99,25,51,0.49,4,6,0.667,21,45,0.467,0.529,7,7,1,3,15,18,7,2,1,6,2,61
2017,Tim Hardaway,SG,24,ATL,6,6,200,27,82,0.329,11,42,0.262,16,40,0.4,0.396,12,19,0.632,3,13,16,7,3,0,10,13,77
2017,James Harden,PG,27,HOU,11,11,407,90,218,0.413,32,115,0.278,58,103,0.563,0.486,101,115,0.878,7,53,60,93,21,5,59,43,313
2017,Maurice Harkless,SF,23,POR,4,4,99,10,34,0.294,2,12,0.167,8,22,0.364,0.324,7,8,0.875,7,6,13,3,5,5,1,14,29
2017,Montrezl Harrell,C,23,HOU,5,0,21,1,3,0.333,0,0,0,1,3,0.333,0.333,3,6,0.5,1,5,6,2,0,0,2,7,5
2017,Andrew Harrison,PG,22,MEM,6,0,119,13,29,0.448,5,13,0.385,8,16,0.5,0.534,8,9,0.889,4,7,11,13,3,1,3,14,39
2017,Spencer Hawes,PF,28,MIL,3,0,17,2,5,0.4,1,2,0.5,1,3,0.333,0.5,0,0,0,2,2,4,1,0,1,1,3,5
2017,Gordon Hayward,SF,26,UTA,11,11,411,83,188,0.441,28,68,0.412,55,120,0.458,0.516,71,76,0.934,7,60,67,37,10,3,24,23,265
2017,John Henson,C,26,MIL,2,0,12,1,4,0.25,0,0,0,1,4,0.25,0.25,1,1,1,2,2,4,0,1,0,1,1,3
2017,Nene Hilario,C,34,HOU,9,0,161,36,51,0.706,0,1,0,36,50,0.72,0.706,18,31,0.581,11,31,42,5,6,4,9,24,90
2017,George Hill,PG,30,UTA,8,8,281,46,98,0.469,12,31,0.387,34,67,0.507,0.531,21,29,0.724,8,25,33,29,2,1,13,25,125
2017,Rodney Hood,SG,24,UTA,11,0,277,37,105,0.352,13,50,0.26,24,55,0.436,0.414,11,18,0.611,1,29,30,12,5,0,10,30,98
2017,Al Horford,C,30,BOS,18,18,610,111,190,0.584,27,52,0.519,84,138,0.609,0.655,22,29,0.759,31,87,118,97,15,14,33,33,271
2017,Dwight Howard,C,31,ATL,6,6,157,18,36,0.5,0,0,0,18,36,0.5,0.5,12,19,0.632,18,46,64,8,6,5,11,21,48
2017,Kris Humphries,PF,31,ATL,1,0,3,0,0,,0,0,0,0,0,0,,0,0,0,0,0,0,0,0,1,0,0,0
2017,Serge Ibaka,PF,27,TOR,10,10,307,60,130,0.462,12,38,0.316,48,92,0.522,0.508,11,13,0.846,9,56,65,14,4,17,11,37,143
2017,Andre Iguodala,SF,33,GSW,16,0,419,46,101,0.455,8,42,0.19,38,59,0.644,0.495,15,26,0.577,9,56,65,51,14,7,16,29,115
2017,Ersan Ilyasova,PF,29,ATL,6,0,90,8,23,0.348,1,5,0.2,7,18,0.389,0.37,7,9,0.778,14,17,31,2,1,0,5,7,24
2017,Joe Ingles,SF,29,UTA,11,11,334,25,62,0.403,15,41,0.366,10,21,0.476,0.524,6,9,0.667,2,39,41,36,22,5,16,28,71
2017,Kyrie Irving,PG,24,CLE,18,18,653,173,370,0.468,44,118,0.373,129,252,0.512,0.527,76,84,0.905,13,38,51,95,23,8,48,38,466
2017,LeBron James,SF,32,CLE,18,18,744,217,384,0.565,44,107,0.411,173,277,0.625,0.622,113,162,0.698,19,145,164,141,35,23,72,43,591
2017,Richard Jefferson,SF,36,CLE,14,0,179,16,38,0.421,5,19,0.263,11,19,0.579,0.487,18,28,0.643,10,15,25,7,2,3,8,30,55
2017,Brandon Jennings,PG,27,WAS,13,0,178,14,36,0.389,2,13,0.154,12,23,0.522,0.417,7,8,0.875,5,14,19,24,2,0,8,13,37
2017,Jonas Jerebko,PF,29,BOS,12,0,128,15,31,0.484,5,15,0.333,10,16,0.625,0.565,8,8,1,7,22,29,12,5,3,6,13,43
2017,Amir Johnson,PF,29,BOS,14,9,142,15,30,0.5,1,3,0.333,14,27,0.519,0.517,5,8,0.625,17,13,30,3,4,6,6,24,36
2017,Joe Johnson,SF,35,UTA,11,2,326,58,133,0.436,15,45,0.333,43,88,0.489,0.492,11,15,0.733,8,35,43,27,6,1,13,21,142
2017,Wesley Johnson,SF,29,LAC,3,0,11,0,0,,0,0,0,0,0,0,,1,2,0.5,0,2,2,0,1,0,0,2,1
2017,Dahntay Jones,SF,36,CLE,10,0,33,5,10,0.5,1,2,0.5,4,8,0.5,0.55,5,5,1,1,6,7,1,0,1,1,7,16
2017,Damian Jones,C,21,GSW,4,0,21,3,7,0.429,0,0,0,3,7,0.429,0.429,1,2,0.5,4,2,6,0,2,1,0,3,7
2017,James Jones,SF,36,CLE,8,0,30,1,5,0.2,0,3,0,1,2,0.5,0.2,0,0,0,1,3,4,0,0,0,2,3,2
2017,DeAndre Jordan,C,28,LAC,7,7,264,43,61,0.705,0,1,0,43,60,0.717,0.705,22,56,0.393,25,76,101,5,3,6,17,29,108
2017,Cory Joseph,PG,25,TOR,10,2,212,31,71,0.437,9,22,0.409,22,49,0.449,0.5,8,8,1,4,17,21,31,4,2,14,17,79
2017,Enes Kanter,C,24,OKC,5,0,45,10,26,0.385,0,0,0,10,26,0.385,0.385,4,4,1,3,6,9,1,0,4,2,8,24
2017,Kyle Korver,SG,35,CLE,18,0,326,34,80,0.425,27,69,0.391,7,11,0.636,0.594,10,10,1,2,28,30,13,7,5,7,22,105
2017,Joffrey Lauvergne,C,25,CHI,3,0,26,4,11,0.364,0,2,0,4,9,0.444,0.364,6,6,1,5,4,9,5,0,0,2,1,14
2017,Jake Layman,SF,22,POR,2,0,16,2,4,0.5,1,1,1,1,3,0.333,0.625,1,2,0.5,0,1,1,1,1,0,0,2,6
2017,David Lee,PF,33,SAS,15,4,245,25,48,0.521,0,1,0,25,47,0.532,0.521,11,17,0.647,20,37,57,11,4,5,6,20,61
2017,Kawhi Leonard,SF,25,SAS,12,12,429,106,202,0.525,25,55,0.455,81,147,0.551,0.587,95,102,0.931,19,74,93,55,20,6,26,21,332
2017,Meyers Leonard,PF,24,POR,3,1,31,1,5,0.2,0,4,0,1,1,1,0.2,0,0,0,2,6,8,1,0,0,4,6,2
2017,Damian Lillard,PG,26,POR,4,4,151,39,90,0.433,9,32,0.281,30,58,0.517,0.483,24,25,0.96,4,14,18,13,5,2,13,11,111
2017,Shaun Livingston,PG,31,GSW,14,0,220,34,59,0.576,0,0,0,34,59,0.576,0.576,5,7,0.714,10,19,29,20,5,2,10,24,73
2017,Robin Lopez,C,28,CHI,6,6,162,34,52,0.654,0,0,0,34,52,0.654,0.654,8,8,1,28,15,43,5,3,6,8,13,76
2017,Kevin Love,PF,28,CLE,18,18,578,95,218,0.436,50,111,0.45,45,107,0.421,0.55,63,75,0.84,36,155,191,30,21,16,31,46,303
2017,Kyle Lowry,PG,30,TOR,8,8,300,43,93,0.462,13,38,0.342,30,55,0.545,0.532,27,33,0.818,3,22,25,47,12,4,17,26,126
2017,Trey Lyles,PF,21,UTA,2,0,10,3,7,0.429,1,3,0.333,2,4,0.5,0.5,0,0,0,0,2,2,1,1,0,1,1,7
2017,Sheldon Mac,SG,24,WAS,7,0,17,5,9,0.556,2,5,0.4,3,4,0.75,0.667,2,2,1,0,2,2,0,0,0,1,1,14
2017,Shelvin Mack,PG,26,UTA,9,3,155,17,49,0.347,7,15,0.467,10,34,0.294,0.418,13,15,0.867,3,22,25,18,4,0,9,14,54
2017,Ian Mahinmi,C,30,WAS,5,0,63,5,9,0.556,0,0,0,5,9,0.556,0.556,4,11,0.364,3,8,11,6,1,6,3,17,14
2017,Thon Maker,C,19,MIL,6,6,116,12,31,0.387,2,10,0.2,10,21,0.476,0.419,9,11,0.818,8,11,19,12,5,11,8,18,35
2017,Jarell Martin,PF,22,MEM,3,0,10,1,3,0.333,0,0,0,1,3,0.333,0.333,0,0,0,2,2,4,0,1,0,0,2,2
2017,Luc Mbah a Moute,SF,30,LAC,7,7,224,17,43,0.395,5,16,0.313,12,27,0.444,0.453,14,20,0.7,10,25,35,7,8,4,3,16,53
2017,James Michael McAdoo,PF,24,GSW,13,0,56,9,17,0.529,2,5,0.4,7,12,0.583,0.588,4,6,0.667,5,8,13,0,2,2,1,5,24
2017,Patrick McCaw,SG,21,GSW,15,3,181,21,48,0.438,8,23,0.348,13,25,0.52,0.521,11,13,0.846,10,23,33,16,9,3,3,14,61
2017,CJ McCollum,SG,25,POR,4,4,140,32,80,0.4,11,22,0.5,21,58,0.362,0.469,15,16,0.938,8,16,24,4,4,2,15,10,90
2017,Doug McDermott,SF,25,OKC,5,0,66,9,18,0.5,7,13,0.538,2,5,0.4,0.694,0,0,0,0,5,5,1,1,1,1,2,25
2017,JaVale McGee,C,29,GSW,16,1,149,41,56,0.732,0,0,0,41,56,0.732,0.732,13,18,0.722,22,26,48,4,2,15,8,31,95
2017,Jordan Mickey,PF,22,BOS,2,0,18,2,5,0.4,0,0,0,2,5,0.4,0.4,0,0,0,0,5,5,0,0,1,1,3,4
2017,Khris Middleton,SF,25,MIL,6,6,231,31,78,0.397,7,19,0.368,24,59,0.407,0.442,18,22,0.818,0,28,28,32,12,0,11,17,87
2017,C.J. Miles,SF,29,IND,4,2,82,11,24,0.458,5,16,0.313,6,8,0.75,0.563,2,2,1,4,4,8,1,2,1,2,12,29
2017,Patty Mills,PG,28,SAS,16,6,416,57,140,0.407,32,89,0.36,25,51,0.49,0.521,19,22,0.864,5,29,34,43,13,1,21,33,165
2017,Paul Millsap,PF,31,ATL,6,6,219,50,99,0.505,3,17,0.176,47,82,0.573,0.52,43,53,0.811,9,47,56,26,10,4,23,19,146
2017,Nikola Mirotic,PF,25,CHI,6,6,162,17,50,0.34,10,35,0.286,7,15,0.467,0.44,8,10,0.8,4,26,30,9,4,3,4,16,52
2017,Greg Monroe,C,26,MIL,6,0,141,27,51,0.529,0,0,0,27,51,0.529,0.529,25,30,0.833,17,27,44,10,8,3,11,16,79
2017,Markieff Morris,PF,27,WAS,13,13,373,59,145,0.407,14,38,0.368,45,107,0.421,0.455,25,31,0.806,18,65,83,22,12,17,21,46,157
2017,Anthony Morrow,SG,31,CHI,3,0,29,5,9,0.556,0,0,0,5,9,0.556,0.556,2,2,1,0,3,3,2,0,0,0,2,12
2017,Dejounte Murray,PG,20,SAS,11,2,168,23,61,0.377,0,3,0,23,58,0.397,0.377,17,25,0.68,4,23,27,27,16,1,16,14,63
2017,Mike Muscala,C,25,ATL,6,0,81,5,18,0.278,0,4,0,5,14,0.357,0.278,7,8,0.875,6,10,16,2,1,3,1,12,17
2017,Shabazz Napier,PG,25,POR,4,0,47,8,19,0.421,5,11,0.455,3,8,0.375,0.553,6,8,0.75,1,3,4,3,2,0,0,6,27
2017,Raul Neto,PG,24,UTA,9,0,60,8,13,0.615,3,6,0.5,5,7,0.714,0.731,4,4,1,0,7,7,4,1,1,3,8,23
2017,Lucas Nogueira,C,24,TOR,3,0,7,1,2,0.5,0,0,0,1,2,0.5,0.5,1,2,0.5,2,3,5,0,0,0,0,1,3
2017,Jusuf Nurkic,C,22,POR,1,1,17,1,3,0.333,0,1,0,1,2,0.5,0.333,0,0,0,0,11,11,4,0,1,3,1,2
2017,Daniel Ochefu,C,23,WAS,4,0,5,0,1,0,0,0,0,0,1,0,0,0,0,0,0,1,1,0,0,0,1,1,0
2017,Victor Oladipo,SG,24,OKC,5,5,181,21,61,0.344,6,25,0.24,15,36,0.417,0.393,6,6,1,2,26,28,10,7,3,6,17,54
2017,Kelly Olynyk,C,25,BOS,18,2,346,64,125,0.512,15,47,0.319,49,78,0.628,0.572,22,30,0.733,14,43,57,34,13,14,22,47,165
2017,Kelly Oubre,SF,21,WAS,12,0,184,26,61,0.426,11,30,0.367,15,31,0.484,0.516,7,10,0.7,9,19,28,4,10,5,7,38,70
2017,Zaza Pachulia,C,32,GSW,15,15,212,32,60,0.533,0,1,0,32,59,0.542,0.533,13,17,0.765,18,39,57,12,8,4,14,32,77
2017,Tony Parker,PG,34,SAS,8,8,211,51,97,0.526,11,19,0.579,40,78,0.513,0.582,14,14,1,2,18,20,25,4,0,12,10,127
2017,Patrick Patterson,PF,27,TOR,10,1,185,10,36,0.278,8,26,0.308,2,10,0.2,0.389,6,6,1,1,19,20,20,7,2,6,4,34
2017,Chris Paul,PG,31,LAC,7,7,260,67,135,0.496,14,38,0.368,53,97,0.546,0.548,29,33,0.879,4,31,35,69,12,1,19,24,177
2017,Cameron Payne,PG,22,CHI,1,0,4,1,2,0.5,1,1,1,0,1,0,0.75,0,0,0,0,1,1,0,0,0,1,0,3
2017,Paul Pierce,SF,39,LAC,7,0,101,8,18,0.444,4,10,0.4,4,8,0.5,0.556,1,1,1,2,12,14,7,2,0,4,11,21
2017,Jakob Poeltl,C,21,TOR,6,0,26,5,11,0.455,0,0,0,5,11,0.455,0.455,0,2,0,6,6,12,0,1,1,0,3,10
2017,Otto Porter,SF,23,WAS,13,13,428,58,109,0.532,11,39,0.282,47,70,0.671,0.583,31,35,0.886,15,75,90,23,21,7,10,26,158
2017,Bobby Portis,PF,21,CHI,6,0,121,17,33,0.515,6,13,0.462,11,20,0.55,0.606,0,0,0,5,31,36,7,3,3,6,10,40
2017,Norman Powell,SG,23,TOR,9,5,227,35,82,0.427,15,34,0.441,20,48,0.417,0.518,20,24,0.833,5,23,28,14,10,3,15,25,105
2017,Tim Quarterman,SG,22,POR,2,0,7,1,2,0.5,1,2,0.5,0,0,0,0.75,0,0,0,0,0,0,1,0,0,0,1,3
2017,Zach Randolph,PF,35,MEM,6,4,191,35,83,0.422,1,7,0.143,34,76,0.447,0.428,8,11,0.727,9,40,49,4,5,2,7,14,79
2017,J.J. Redick,SG,32,LAC,7,7,206,19,50,0.38,9,26,0.346,10,24,0.417,0.47,17,20,0.85,0,12,12,6,2,0,13,17,64
2017,Austin Rivers,SG,24,LAC,3,2,90,9,26,0.346,4,13,0.308,5,13,0.385,0.423,2,2,1,1,7,8,2,1,1,5,6,24
2017,Andre Roberson,SF,25,OKC,5,5,185,24,46,0.522,7,17,0.412,17,29,0.586,0.598,3,21,0.143,18,13,31,9,12,17,7,15,58
2017,Glenn Robinson,SF,23,IND,3,0,31,6,6,1,2,2,1,4,4,1,1.167,1,2,0.5,0,3,3,1,0,0,0,2,15
2017,Rajon Rondo,PG,30,CHI,2,2,67,11,26,0.423,0,6,0,11,20,0.55,0.423,1,2,0.5,7,10,17,20,7,1,4,6,23
2017,Terry Rozier,PG,22,BOS,17,0,277,33,82,0.402,14,38,0.368,19,44,0.432,0.488,16,20,0.8,12,32,44,32,11,4,10,20,96
2017,Domantas Sabonis,PF,20,OKC,2,0,6,0,3,0,0,1,0,0,2,0,0,4,4,1,0,2,2,0,1,1,0,4,4
2017,Tomas Satoransky,SG,25,WAS,10,0,36,3,6,0.5,0,0,0,3,6,0.5,0.5,2,5,0.4,1,4,5,6,1,0,2,4,8
2017,Dennis Schroder,PG,23,ATL,6,6,211,50,110,0.455,17,40,0.425,33,70,0.471,0.532,31,37,0.838,4,10,14,46,6,0,10,19,148
2017,Thabo Sefolosha,SF,32,ATL,4,0,9,0,1,0,0,0,0,0,1,0,0,1,4,0.25,0,0,0,0,0,0,0,1,1
2017,Wayne Selden,SG,22,MEM,6,2,106,9,26,0.346,2,11,0.182,7,15,0.467,0.385,3,4,0.75,3,6,9,7,1,1,2,8,23
2017,Kevin Seraphin,PF,27,IND,4,0,59,12,26,0.462,0,0,0,12,26,0.462,0.462,5,7,0.714,8,6,14,4,0,2,4,10,29
2017,Iman Shumpert,SG,26,CLE,17,0,275,25,60,0.417,10,26,0.385,15,34,0.441,0.5,14,17,0.824,6,41,47,16,10,3,6,32,74
2017,Pascal Siakam,PF,22,TOR,2,0,10,0,2,0,0,0,0,0,2,0,0,0,0,0,2,1,3,1,1,0,0,1,0
2017,Jonathon Simmons,SG,27,SAS,15,4,306,62,136,0.456,13,37,0.351,49,99,0.495,0.504,21,31,0.677,9,19,28,29,9,2,11,30,158
2017,Kyle Singler,SF,28,OKC,1,0,10,0,1,0,0,0,0,0,1,0,0,0,0,0,0,1,1,0,0,0,0,2,0
2017,Marcus Smart,SG,22,BOS,18,3,538,47,134,0.351,29,73,0.397,18,61,0.295,0.459,32,50,0.64,23,62,85,85,27,16,38,51,155
2017,J.R. Smith,SG,31,CLE,18,18,487,50,99,0.505,40,80,0.5,10,19,0.526,0.707,5,11,0.455,5,37,42,13,13,6,12,41,145
2017,Jason Smith,C,30,WAS,13,0,157,19,39,0.487,3,10,0.3,16,29,0.552,0.526,10,14,0.714,10,19,29,4,2,7,10,30,51
2017,Tony Snell,SG,25,MIL,6,6,185,22,44,0.5,16,31,0.516,6,13,0.462,0.682,0,0,0,2,12,14,9,1,1,2,17,60
2017,Marreese Speights,C,29,LAC,7,2,98,16,37,0.432,7,20,0.35,9,17,0.529,0.527,7,10,0.7,4,16,20,3,2,3,3,13,46
2017,Lance Stephenson,SG,26,IND,4,0,107,27,53,0.509,7,18,0.389,20,35,0.571,0.575,3,4,0.75,1,20,21,11,2,0,4,11,64
2017,Isaiah Taylor,PG,22,HOU,3,0,10,0,2,0,0,1,0,0,1,0,0,0,0,0,1,1,2,1,0,0,0,1,0
2017,Jeff Teague,PG,28,IND,4,4,142,22,45,0.489,9,17,0.529,13,28,0.464,0.589,15,18,0.833,0,13,13,25,4,3,8,12,68
2017,Mirza Teletovic,PF,31,MIL,3,0,27,1,6,0.167,1,4,0.25,0,2,0,0.25,0,0,0,0,3,3,0,1,0,1,3,3
2017,Jason Terry,SG,39,MIL,6,0,68,6,18,0.333,2,10,0.2,4,8,0.5,0.389,1,1,1,2,6,8,5,3,1,2,7,15
2017,Isaiah Thomas,PG,27,BOS,15,15,521,111,261,0.425,36,108,0.333,75,153,0.49,0.494,91,111,0.82,5,42,47,100,13,2,50,35,349
2017,Klay Thompson,SG,26,GSW,17,17,596,94,237,0.397,41,106,0.387,53,131,0.405,0.483,26,33,0.788,11,55,66,35,14,5,24,44,255
2017,Tristan Thompson,C,25,CLE,18,18,562,54,92,0.587,0,0,0,54,92,0.587,0.587,40,60,0.667,69,81,150,26,9,13,21,36,148
2017,P.J. Tucker,SF,31,TOR,10,1,251,18,49,0.367,9,28,0.321,9,21,0.429,0.459,5,8,0.625,15,42,57,11,6,3,8,27,50
2017,Evan Turner,SF,28,POR,4,4,124,12,33,0.364,5,15,0.333,7,18,0.389,0.439,12,16,0.75,3,20,23,15,7,2,7,7,41
2017,Myles Turner,C,20,IND,4,4,133,19,44,0.432,0,6,0,19,38,0.5,0.432,5,8,0.625,6,21,27,3,7,5,6,15,43
2017,Jonas Valanciunas,C,24,TOR,10,6,226,44,81,0.543,0,1,0,44,80,0.55,0.543,24,33,0.727,9,58,67,2,2,6,13,22,112
2017,Denzel Valentine,SG,23,CHI,4,0,22,2,6,0.333,1,4,0.25,1,2,0.5,0.417,0,0,0,0,8,8,2,0,1,2,1,5
2017,Fred VanVleet,PG,22,TOR,7,0,29,6,9,0.667,2,5,0.4,4,4,1,0.778,0,0,0,0,1,1,4,1,0,1,3,14
2017,Rashad Vaughn,SG,20,MIL,3,0,10,2,4,0.5,2,2,1,0,2,0,0.75,0,0,0,0,0,0,0,0,0,0,0,6
2017,Noah Vonleh,PF,21,POR,4,2,100,8,18,0.444,0,0,0,8,18,0.444,0.444,2,5,0.4,9,20,29,8,1,3,6,11,18
2017,Dwyane Wade,SG,35,CHI,6,6,190,32,86,0.372,6,17,0.353,26,69,0.377,0.407,20,21,0.952,6,24,30,24,5,8,10,8,90
2017,John Wall,PG,26,WAS,13,13,507,127,281,0.452,21,61,0.344,106,220,0.482,0.489,78,93,0.839,7,41,48,134,22,15,55,26,353
2017,Taurean Waller-Prince,SF,22,ATL,6,6,187,29,52,0.558,4,14,0.286,25,38,0.658,0.596,5,5,1,7,25,32,8,2,1,7,9,67
2017,David West,C,36,GSW,17,0,221,34,59,0.576,1,2,0.5,33,57,0.579,0.585,7,9,0.778,7,39,46,36,7,13,10,26,76
2017,Russell Westbrook,PG,28,OKC,5,5,194,59,152,0.388,13,49,0.265,46,103,0.447,0.431,56,70,0.8,9,49,58,54,12,2,30,16,187
2017,Deron Williams,PG,32,CLE,18,0,262,28,64,0.438,12,31,0.387,16,33,0.485,0.531,10,11,0.909,3,20,23,38,10,1,17,29,78
2017,Derrick Williams,PF,25,CLE,8,0,38,8,15,0.533,3,5,0.6,5,10,0.5,0.633,2,2,1,1,2,3,4,0,1,3,0,21
2017,Lou Williams,SG,30,HOU,11,0,272,50,118,0.424,12,39,0.308,38,79,0.481,0.475,26,29,0.897,7,23,30,14,7,1,14,17,138
2017,Troy Williams,SF,22,HOU,5,0,19,0,9,0,0,5,0,0,4,0,0,1,2,0.5,2,5,7,1,0,0,2,0,1
2017,Kyle Wiltjer,PF,24,HOU,1,0,5,1,1,1,1,1,1,0,0,0,1.5,0,0,0,0,0,0,0,0,0,0,0,3
2017,Jeff Withey,C,26,UTA,3,0,21,2,4,0.5,0,0,0,2,4,0.5,0.5,1,2,0.5,3,1,4,1,1,1,0,5,5
2017,Brandan Wright,PF,29,MEM,2,0,12,2,5,0.4,0,0,0,2,5,0.4,0.4,0,0,0,1,1,2,0,0,2,1,0,4
2017,Delon Wright,PG,24,TOR,9,0,92,9,17,0.529,2,6,0.333,7,11,0.636,0.588,5,7,0.714,4,9,13,13,4,1,5,4,25
2017,James Young,SG,21,BOS,10,0,39,5,15,0.333,5,14,0.357,0,1,0,0.5,0,0,0,1,6,7,3,0,0,1,2,15
2017,Thaddeus Young,PF,28,IND,4,4,140,21,39,0.538,1,4,0.25,20,35,0.571,0.551,5,10,0.5,22,14,36,10,8,1,6,11,48
2017,Tyler Zeller,C,27,BOS,11,0,78,13,25,0.52,0,0,0,13,25,0.52,0.52,6,8,0.75,8,11,19,8,0,2,4,7,32
2017,Paul Zipser,SF,22,CHI,6,0,136,15,33,0.455,6,16,0.375,9,17,0.529,0.545,8,8,1,3,18,21,3,1,1,7,12,44
2018,Alex Abrines,SG,24,OKC,6,0,110,8,20,0.4,6,13,0.462,2,7,0.286,0.55,2,2,1,3,13,16,2,5,2,1,11,24
2018,Steven Adams,C,24,OKC,6,6,200,27,46,0.587,0,0,0,27,46,0.587,0.587,9,13,0.692,19,26,45,9,4,4,4,15,63
2018,Bam Adebayo,C,20,MIA,5,0,77,7,15,0.467,0,1,0,7,14,0.5,0.467,3,14,0.214,9,11,20,0,0,2,2,8,17
2018,LaMarcus Aldridge,C,32,SAS,5,5,177,37,80,0.463,3,5,0.6,34,75,0.453,0.481,41,42,0.976,13,33,46,12,3,2,9,9,118
2018,Al-Farouq Aminu,PF,27,POR,4,4,131,27,52,0.519,13,30,0.433,14,22,0.636,0.644,2,2,1,12,24,36,5,4,2,6,8,69
2018,Justin Anderson,SF,24,PHI,7,0,33,3,8,0.375,2,7,0.286,1,1,1,0.5,0,0,0,1,8,9,0,1,0,2,8,8
2018,Kyle Anderson,SF,24,SAS,5,1,73,12,20,0.6,0,4,0,12,16,0.75,0.6,3,4,0.75,5,8,13,3,6,1,3,10,27
2018,Ryan Anderson,PF,29,HOU,11,0,95,7,20,0.35,5,15,0.333,2,5,0.4,0.475,0,0,0,4,9,13,6,3,1,3,10,19
2018,Giannis Antetokounmpo,PF,23,MIL,7,7,280,69,121,0.57,4,14,0.286,65,107,0.607,0.587,38,55,0.691,8,59,67,44,10,6,17,28,180
2018,Carmelo Anthony,PF,33,OKC,6,6,194,27,72,0.375,6,28,0.214,21,44,0.477,0.417,11,15,0.733,3,31,34,2,10,4,6,14,71
2018,OG Anunoby,SF,20,TOR,10,10,238,29,52,0.558,13,29,0.448,16,23,0.696,0.683,8,11,0.727,9,12,21,7,6,4,6,23,79
2018,Trevor Ariza,SF,32,HOU,17,17,582,50,139,0.36,26,91,0.286,24,48,0.5,0.453,23,31,0.742,9,56,65,22,19,2,10,44,149
2018,Luke Babbitt,SF,28,MIA,2,0,3,0,1,0,0,0,0,0,1,0,0,0,0,0,0,0,0,0,0,0,0,0,0
2018,Wade Baldwin,PG,21,POR,4,0,19,1,4,0.25,1,1,1,0,3,0,0.375,1,2,0.5,0,3,3,3,1,1,3,1,4
2018,Jerryd Bayless,SG,29,PHI,1,0,2,0,0,,0,0,0,0,0,0,,0,0,0,0,0,0,0,0,0,0,0,0
2018,Aron Baynes,C,31,BOS,19,12,389,45,89,0.506,11,23,0.478,34,66,0.515,0.567,13,18,0.722,45,73,118,19,4,11,8,43,114
2018,Bradley Beal,SG,24,WAS,6,6,216,49,108,0.454,21,45,0.467,28,63,0.444,0.551,20,23,0.87,2,18,20,17,7,2,15,19,139
2018,Marco Belinelli,SG,31,PHI,10,0,273,43,106,0.406,16,46,0.348,27,60,0.45,0.481,27,31,0.871,1,20,21,20,7,0,4,20,129
2018,Jordan Bell,C,23,GSW,17,0,173,17,32,0.531,0,1,0,17,31,0.548,0.531,7,14,0.5,15,32,47,15,6,9,6,18,41
2018,Davis Bertans,PF,25,SAS,5,0,82,3,18,0.167,3,16,0.188,0,2,0,0.25,8,11,0.727,1,10,11,6,2,0,1,10,17
2018,Nemanja Bjelica,PF,29,MIN,5,0,47,7,16,0.438,4,7,0.571,3,9,0.333,0.563,5,7,0.714,4,11,15,3,3,0,1,6,23
2018,Tarik Black,C,26,HOU,7,0,19,1,4,0.25,0,0,0,1,4,0.25,0.25,0,0,0,2,4,6,2,0,1,1,5,2
2018,Eric Bledsoe,PG,28,MIL,7,7,225,37,84,0.44,7,22,0.318,30,62,0.484,0.482,14,20,0.7,3,22,25,26,7,6,15,19,95
2018,Bojan Bogdanovic,SF,28,IND,7,7,238,32,81,0.395,17,45,0.378,15,36,0.417,0.5,6,10,0.6,1,23,24,13,6,0,13,23,87
2018,Trevor Booker,PF,30,IND,7,0,64,6,10,0.6,0,1,0,6,9,0.667,0.6,6,7,0.857,5,13,18,0,1,1,1,12,18
2018,Tony Bradley,C,20,UTA,1,0,2,1,2,0.5,0,0,0,1,2,0.5,0.5,0,0,0,1,0,1,0,0,0,0,0,2
2018,Corey Brewer,SG,31,OKC,6,6,151,13,25,0.52,5,11,0.455,8,14,0.571,0.62,6,6,1,4,9,13,5,7,5,2,17,37
2018,Malcolm Brogdon,PG,25,MIL,7,5,186,24,55,0.436,5,19,0.263,19,36,0.528,0.482,8,10,0.8,3,21,24,17,1,0,12,14,61
2018,Aaron Brooks,PG,33,MIN,2,0,3,2,3,0.667,0,1,0,2,2,1,0.667,0,2,0,0,0,0,0,0,0,0,0,4
2018,Jaylen Brown,SG,21,BOS,18,15,583,124,266,0.466,44,112,0.393,80,154,0.519,0.549,32,50,0.64,16,71,87,26,14,10,23,58,324
2018,Lorenzo Brown,PG,27,TOR,4,0,29,3,10,0.3,2,5,0.4,1,5,0.2,0.4,1,2,0.5,1,5,6,2,0,1,1,2,9
2018,Sterling Brown,SG,22,MIL,3,0,13,3,5,0.6,1,3,0.333,2,2,1,0.7,0,0,0,1,1,2,0,1,0,0,2,7
2018,Alec Burks,SG,26,UTA,9,0,120,30,64,0.469,9,20,0.45,21,44,0.477,0.539,13,15,0.867,2,22,24,17,4,1,8,9,82
2018,Jimmy Butler,SG,28,MIN,5,5,170,28,63,0.444,8,17,0.471,20,46,0.435,0.508,15,18,0.833,3,27,30,20,4,1,5,9,79
2018,Jose Calderon,PG,36,CLE,13,3,104,9,26,0.346,4,18,0.222,5,8,0.625,0.423,2,2,1,2,9,11,9,5,0,5,15,24
2018,Clint Capela,C,23,HOU,17,17,520,95,144,0.66,0,0,0,95,144,0.66,0.66,26,55,0.473,61,136,197,22,14,36,15,38,216
2018,Ian Clark,SG,26,NOP,9,0,190,28,66,0.424,10,28,0.357,18,38,0.474,0.5,4,4,1,2,8,10,11,8,2,9,20,70
2018,Jordan Clarkson,SG,25,CLE,19,0,286,37,123,0.301,11,46,0.239,26,77,0.338,0.346,5,6,0.833,9,23,32,13,8,3,13,21,90
2018,Zach Collins,C,20,POR,4,0,70,11,30,0.367,3,14,0.214,8,16,0.5,0.417,3,4,0.75,3,9,12,6,3,2,2,10,28
2018,Darren Collison,PG,30,IND,7,7,214,31,68,0.456,8,23,0.348,23,45,0.511,0.515,9,12,0.75,1,20,21,33,7,0,9,7,79
2018,Pat Connaughton,SG,25,POR,4,0,59,6,15,0.4,2,10,0.2,4,5,0.8,0.467,2,2,1,2,2,4,6,1,1,1,9,16
2018,Quinn Cook,PG,24,GSW,17,0,175,30,67,0.448,7,31,0.226,23,36,0.639,0.5,14,17,0.824,2,21,23,11,4,2,5,13,81
2018,Robert Covington,SF,27,PHI,10,8,281,27,83,0.325,15,48,0.313,12,35,0.343,0.416,12,16,0.75,12,41,53,25,11,9,11,30,81
2018,Jamal Crawford,SG,37,MIN,5,0,123,21,47,0.447,7,17,0.412,14,30,0.467,0.521,10,13,0.769,1,12,13,12,5,0,5,6,59
2018,Jordan Crawford,SG,29,NOP,2,0,15,8,13,0.615,3,8,0.375,5,5,1,0.731,0,0,0,0,4,4,1,1,0,3,1,19
2018,Jae Crowder,SF,27,UTA,11,2,323,35,108,0.324,22,66,0.333,13,42,0.31,0.426,18,28,0.643,4,52,56,19,15,2,14,25,110
2018,Stephen Curry,PG,29,GSW,15,14,555,137,304,0.451,64,162,0.395,73,142,0.514,0.556,45,47,0.957,9,82,91,81,26,11,43,38,383
2018,Anthony Davis,PF,24,NOP,9,9,358,106,204,0.52,6,22,0.273,100,182,0.549,0.534,53,64,0.828,24,97,121,15,18,21,23,30,271
2018,Ed Davis,C,28,POR,4,0,71,5,10,0.5,0,0,0,5,10,0.5,0.5,1,4,0.25,5,27,32,0,0,1,4,7,11
2018,Matthew Dellavedova,PG,27,MIL,6,0,78,4,12,0.333,2,9,0.222,2,3,0.667,0.417,2,2,1,1,4,5,16,2,0,6,6,12
2018,DeMar DeRozan,SG,28,TOR,10,10,354,87,199,0.437,10,35,0.286,77,164,0.47,0.462,43,53,0.811,6,30,36,40,5,6,23,24,227
2018,Cheick Diallo,PF,21,NOP,7,0,48,5,12,0.417,0,0,0,5,12,0.417,0.417,0,0,0,4,5,9,0,1,1,1,9,10
2018,Gorgui Dieng,C,28,MIN,5,0,70,6,18,0.333,2,5,0.4,4,13,0.308,0.389,3,4,0.75,3,15,18,4,2,4,1,6,17
2018,Goran Dragic,PG,31,MIA,5,5,156,35,75,0.467,8,21,0.381,27,54,0.5,0.52,15,22,0.682,3,10,13,23,5,0,15,15,93
2018,Kevin Durant,PF,29,GSW,21,21,807,212,435,0.487,47,138,0.341,165,297,0.556,0.541,137,152,0.901,13,150,163,99,15,25,50,43,608
2018,Wayne Ellington,SG,30,MIA,5,0,101,12,35,0.343,12,30,0.4,0,5,0,0.514,3,3,1,1,7,8,3,2,2,3,9,39
2018,Joel Embiid,C,23,PHI,8,8,278,60,138,0.435,8,29,0.276,52,109,0.477,0.464,43,61,0.705,23,78,101,24,7,14,29,31,171
2018,Dante Exum,PG,22,UTA,10,0,114,20,41,0.488,2,7,0.286,18,34,0.529,0.512,9,12,0.75,4,10,14,10,1,1,15,15,51
2018,Derrick Favors,C,26,UTA,11,9,286,42,68,0.618,2,5,0.4,40,63,0.635,0.632,16,33,0.485,20,37,57,13,8,11,10,17,102
2018,Raymond Felton,PG,33,OKC,6,0,79,12,31,0.387,7,14,0.5,5,17,0.294,0.5,0,2,0,2,11,13,9,4,2,5,7,31
2018,Terrance Ferguson,SG,19,OKC,3,0,6,1,1,1,1,1,1,0,0,0,1.5,0,0,0,1,0,1,1,0,0,0,2,3
2018,Bryn Forbes,SG,24,SAS,4,0,54,5,17,0.294,2,9,0.222,3,8,0.375,0.353,5,7,0.714,1,2,3,2,0,0,0,3,17
2018,Tim Frazier,PG,27,WAS,2,0,6,0,1,0,0,0,0,0,1,0,0,0,0,0,0,1,1,3,1,0,0,2,0
2018,Markelle Fultz,SG,19,PHI,3,0,23,1,7,0.143,0,0,0,1,7,0.143,0.143,3,4,0.75,0,3,3,5,2,0,1,4,5
2018,Pau Gasol,C,37,SAS,5,0,90,10,20,0.5,1,3,0.333,9,17,0.529,0.525,9,10,0.9,2,22,24,14,0,1,6,5,30
2018,Rudy Gay,PF,31,SAS,5,4,160,26,65,0.4,4,18,0.222,22,47,0.468,0.431,5,9,0.556,9,19,28,11,8,1,6,16,61
2018,Paul George,SF,27,OKC,6,6,251,49,120,0.408,19,52,0.365,30,68,0.441,0.488,31,36,0.861,4,32,36,16,8,4,24,17,148
2018,Marcus Georges-Hunt,SG,23,MIN,2,0,3,0,1,0,0,0,0,0,1,0,0,0,0,0,1,0,1,0,0,0,0,0,0
2018,Taj Gibson,PF,32,MIN,5,5,123,14,22,0.636,0,0,0,14,22,0.636,0.636,3,3,1,7,13,20,2,1,2,4,8,31
2018,Manu Ginobili,SG,40,SAS,5,0,107,15,37,0.405,6,18,0.333,9,19,0.474,0.486,9,11,0.818,1,14,15,16,7,1,7,13,45
2018,Rudy Gobert,C,25,UTA,11,11,383,55,84,0.655,0,0,0,55,84,0.655,0.655,35,58,0.603,43,75,118,11,10,25,21,34,145
2018,Eric Gordon,SG,29,HOU,17,2,549,84,221,0.38,43,130,0.331,41,91,0.451,0.477,51,61,0.836,9,36,45,28,10,8,24,29,262
2018,Marcin Gortat,C,33,WAS,6,6,160,24,43,0.558,0,0,0,24,43,0.558,0.558,4,7,0.571,13,25,38,6,0,2,6,15,52
2018,Jerami Grant,PF,23,OKC,6,0,133,18,35,0.514,2,8,0.25,16,27,0.593,0.543,5,11,0.455,8,12,20,6,4,3,6,15,43
2018,Danny Green,SG,30,SAS,5,5,103,8,30,0.267,5,20,0.25,3,10,0.3,0.35,0,0,0,4,7,11,1,1,4,2,8,21
2018,Draymond Green,PF,27,GSW,21,21,819,83,192,0.432,21,79,0.266,62,113,0.549,0.487,39,49,0.796,42,180,222,171,41,31,63,75,226
2018,Gerald Green,SG,32,HOU,17,0,272,37,94,0.394,27,72,0.375,10,22,0.455,0.537,6,7,0.857,6,44,50,1,4,7,10,27,107
2018,Jeff Green,PF,31,CLE,22,2,523,58,142,0.408,21,70,0.3,37,72,0.514,0.482,33,46,0.717,7,46,53,32,7,15,17,36,170
2018,James Harden,SG,28,HOU,17,17,621,158,385,0.41,52,174,0.299,106,211,0.502,0.478,118,133,0.887,14,75,89,116,38,11,65,46,486
2018,Maurice Harkless,SF,24,POR,2,1,53,7,13,0.538,2,6,0.333,5,7,0.714,0.615,0,0,0,3,5,8,4,0,1,1,4,16
2018,John Henson,C,27,MIL,2,2,74,9,13,0.692,0,0,0,9,13,0.692,0.692,1,2,0.5,4,8,12,5,0,7,4,4,19
2018,Nene Hilario,C,35,HOU,11,0,107,12,20,0.6,0,0,0,12,20,0.6,0.6,7,11,0.636,6,22,28,5,2,5,8,18,31
2018,George Hill,PG,31,CLE,19,18,557,59,131,0.45,16,51,0.314,43,80,0.538,0.511,41,53,0.774,13,28,41,42,10,8,22,52,175
2018,Solomon Hill,SF,26,NOP,9,0,114,9,25,0.36,6,16,0.375,3,9,0.333,0.48,9,10,0.9,6,11,17,7,1,1,6,17,33
2018,Jrue Holiday,SG,27,NOP,9,9,348,88,170,0.518,16,50,0.32,72,120,0.6,0.565,21,30,0.7,9,42,51,57,10,5,23,22,213
2018,Richaun Holmes,C,24,PHI,3,0,11,0,1,0,0,0,0,0,1,0,0,0,0,0,0,1,1,1,0,0,0,3,0
2018,Rodney Hood,SG,25,CLE,17,1,260,39,92,0.424,4,24,0.167,35,68,0.515,0.446,9,12,0.75,7,24,31,18,5,4,13,30,91
2018,Al Horford,C,31,BOS,19,19,679,111,204,0.544,15,43,0.349,96,161,0.596,0.581,62,75,0.827,32,125,157,63,19,22,32,39,299
2018,Josh Huestis,PF,26,OKC,4,0,19,1,2,0.5,0,0,0,1,2,0.5,0.5,1,2,0.5,0,3,3,0,1,1,0,3,3
2018,Serge Ibaka,PF,28,TOR,10,9,260,30,72,0.417,9,24,0.375,21,48,0.438,0.479,18,22,0.818,13,46,59,11,1,13,16,21,87
2018,Andre Iguodala,SF,34,GSW,15,12,401,42,85,0.494,14,37,0.378,28,48,0.583,0.576,24,34,0.706,11,57,68,41,21,7,14,29,122
2018,Ersan Ilyasova,PF,30,PHI,10,1,233,36,84,0.429,9,31,0.29,27,53,0.509,0.482,12,21,0.571,26,50,76,13,7,4,10,25,93
2018,Joe Ingles,SF,30,UTA,11,11,382,57,121,0.471,35,77,0.455,22,44,0.5,0.616,11,17,0.647,5,43,48,37,6,2,26,29,160
2018,Aaron Jackson,PG,31,HOU,7,0,17,2,4,0.5,0,2,0,2,2,1,0.5,1,2,0.5,2,2,4,2,0,0,2,2,5
2018,LeBron James,PF,33,CLE,22,22,922,275,510,0.539,39,114,0.342,236,396,0.596,0.577,159,213,0.746,31,169,200,198,30,23,94,52,748
2018,Brandon Jennings,PG,28,MIL,1,0,5,0,2,0,0,2,0,0,0,0,0,2,2,1,0,0,0,0,0,0,1,0,2
2018,Jonas Jerebko,PF,30,UTA,10,0,79,8,19,0.421,1,6,0.167,7,13,0.538,0.447,2,2,1,4,12,16,3,3,0,1,9,19
2018,Amir Johnson,C,30,PHI,8,1,94,11,21,0.524,0,0,0,11,21,0.524,0.524,4,5,0.8,14,9,23,9,2,1,3,10,26
2018,Dakari Johnson,C,22,OKC,2,0,3,0,0,,0,0,0,0,0,0,,0,0,0,0,0,0,0,0,0,0,0,0
2018,James Johnson,PF,30,MIA,5,5,161,23,42,0.548,7,13,0.538,16,29,0.552,0.631,9,14,0.643,3,27,30,24,6,6,10,17,62
2018,Joe Johnson,SF,36,HOU,8,0,54,6,17,0.353,0,3,0,6,14,0.429,0.353,0,0,0,0,10,10,3,0,1,3,4,12
2018,Tyler Johnson,PG,25,MIA,5,5,81,14,26,0.538,6,10,0.6,8,16,0.5,0.654,6,7,0.857,1,7,8,4,2,0,2,14,40
2018,Damian Jones,C,22,GSW,4,0,11,1,2,0.5,0,0,0,1,2,0.5,0.5,2,3,0.667,1,2,3,0,0,0,3,4,4
2018,Tyus Jones,PG,21,MIN,4,0,55,2,7,0.286,0,2,0,2,5,0.4,0.286,0,0,0,0,9,9,8,1,0,1,0,4
2018,Cory Joseph,PG,26,IND,7,0,143,12,33,0.364,3,11,0.273,9,22,0.409,0.409,6,6,1,2,15,17,21,9,2,4,10,33
2018,Furkan Korkmaz,SG,20,PHI,1,0,2,1,1,1,1,1,1,0,0,0,1.5,0,0,0,0,0,0,0,0,0,0,1,3
2018,Kyle Korver,SG,36,CLE,22,11,505,59,141,0.418,45,109,0.413,14,32,0.438,0.578,19,22,0.864,6,46,52,19,9,9,14,44,182
2018,Shane Larkin,PG,25,BOS,11,0,154,16,35,0.457,4,13,0.308,12,22,0.545,0.514,5,5,1,1,10,11,20,5,0,6,15,41
2018,Joffrey Lauvergne,C,26,SAS,1,0,6,1,1,1,0,0,0,1,1,1,1,0,0,0,0,1,1,0,0,0,0,0,2
2018,Ty Lawson,PG,30,WAS,5,0,96,9,26,0.346,5,8,0.625,4,18,0.222,0.442,6,6,1,2,11,13,15,3,0,3,6,29
2018,Jake Layman,SF,23,POR,1,0,8,3,3,1,0,0,0,3,3,1,1,0,0,0,0,1,1,1,2,0,0,0,6
2018,T.J. Leaf,PF,20,IND,1,0,4,0,0,,0,0,0,0,0,0,,0,0,0,0,0,0,0,0,0,0,0,0
2018,Meyers Leonard,C,25,POR,2,0,8,4,4,1,0,0,0,4,4,1,1,0,0,0,0,4,4,0,0,0,0,0,8
2018,DeAndre Liggins,SG,29,NOP,3,0,14,0,1,0,0,0,0,0,1,0,0,1,2,0.5,0,1,1,0,0,0,2,0,1
2018,Damian Lillard,PG,27,POR,4,4,162,25,71,0.352,9,30,0.3,16,41,0.39,0.415,15,17,0.882,3,15,18,19,5,0,16,8,74
2018,Shaun Livingston,PG,32,GSW,21,0,362,59,110,0.536,0,1,0,59,109,0.541,0.536,22,25,0.88,11,36,47,31,7,1,16,33,140
2018,Kevon Looney,C,21,GSW,21,5,387,39,72,0.542,0,2,0,39,70,0.557,0.542,8,21,0.381,42,47,89,19,14,8,8,50,86
2018,Kevin Love,C,29,CLE,21,21,660,109,278,0.392,36,106,0.34,73,172,0.424,0.457,59,64,0.922,49,166,215,34,15,8,41,58,313
2018,Kyle Lowry,PG,31,TOR,10,10,361,60,118,0.508,28,63,0.444,32,55,0.582,0.627,26,32,0.813,2,41,43,85,15,0,31,33,174
2018,Ian Mahinmi,C,31,WAS,6,0,52,10,14,0.714,0,0,0,10,14,0.714,0.714,10,11,0.909,4,7,11,1,4,5,1,10,30
2018,Thon Maker,C,20,MIL,6,2,130,11,28,0.393,6,20,0.3,5,8,0.625,0.5,5,7,0.714,6,17,23,5,2,11,4,17,33
2018,Luc Mbah a Moute,PF,31,HOU,9,0,149,9,36,0.25,3,15,0.2,6,21,0.286,0.292,4,7,0.571,3,19,22,3,6,4,6,8,25
2018,Patrick McCaw,SG,22,GSW,6,0,16,1,2,0.5,0,1,0,1,1,1,0.5,2,2,1,1,2,3,0,2,0,0,1,4
2018,CJ McCollum,SG,26,POR,4,4,155,40,77,0.519,11,26,0.423,29,51,0.569,0.591,10,13,0.769,0,8,8,14,5,1,9,11,101
2018,T.J. McConnell,PG,25,PHI,10,2,155,25,36,0.694,2,3,0.667,23,33,0.697,0.722,3,5,0.6,6,20,26,23,6,0,6,13,55
2018,JaVale McGee,C,30,GSW,13,9,158,39,58,0.672,0,1,0,39,57,0.684,0.672,6,9,0.667,16,26,42,4,3,11,5,20,84
2018,Rodney McGruder,SG,26,MIA,4,0,16,1,4,0.25,0,2,0,1,2,0.5,0.25,0,0,0,0,4,4,0,0,0,0,3,2
2018,Khris Middleton,SF,26,MIL,7,7,275,67,112,0.598,25,41,0.61,42,71,0.592,0.71,14,19,0.737,1,35,36,22,6,5,16,30,173
2018,C.J. Miles,SF,30,TOR,10,1,227,32,71,0.451,19,45,0.422,13,26,0.5,0.585,13,16,0.813,6,18,24,8,7,3,9,21,96
2018,Darius Miller,SF,27,NOP,9,0,162,14,34,0.412,9,24,0.375,5,10,0.5,0.544,6,6,1,2,18,20,11,5,0,6,10,43
2018,Patty Mills,PG,29,SAS,5,5,165,25,57,0.439,13,35,0.371,12,22,0.545,0.553,4,5,0.8,2,8,10,13,3,1,9,15,67
2018,Nikola Mirotic,PF,26,NOP,9,9,320,49,102,0.48,22,51,0.431,27,51,0.529,0.588,15,19,0.789,9,77,86,15,10,12,10,24,135
2018,Donovan Mitchell,SG,21,UTA,11,11,411,102,243,0.42,25,80,0.313,77,163,0.472,0.471,39,43,0.907,9,56,65,46,16,4,32,35,268
2018,Greg Monroe,C,27,BOS,11,0,105,19,38,0.5,0,0,0,19,38,0.5,0.5,15,22,0.682,14,21,35,5,2,2,14,9,53
2018,E'Twaun Moore,SG,28,NOP,9,9,284,41,88,0.466,9,25,0.36,32,63,0.508,0.517,11,16,0.688,6,17,23,15,6,1,11,20,102
2018,Marcus Morris,PF,28,BOS,19,4,562,82,223,0.368,30,72,0.417,52,151,0.344,0.435,42,59,0.712,20,83,103,21,7,5,19,60,236
2018,Markieff Morris,PF,28,WAS,6,6,181,24,49,0.49,2,12,0.167,22,37,0.595,0.51,9,10,0.9,14,31,45,10,4,5,6,22,59
2018,Shabazz Muhammad,SG,25,MIL,4,0,29,9,20,0.45,4,5,0.8,5,15,0.333,0.55,3,5,0.6,0,4,4,0,2,1,2,2,25
2018,Dejounte Murray,PG,21,SAS,5,5,96,14,31,0.452,4,6,0.667,10,25,0.4,0.516,7,9,0.778,4,17,21,9,5,2,5,11,39
2018,Abdel Nader,SF,24,BOS,11,0,33,5,15,0.333,0,4,0,5,11,0.455,0.333,2,4,0.5,1,2,3,3,1,1,2,2,12
2018,Larry Nance,C,25,CLE,20,0,307,41,60,0.683,0,1,0,41,59,0.695,0.683,14,31,0.452,35,55,90,18,16,14,12,35,96
2018,Shabazz Napier,PG,26,POR,2,0,35,5,11,0.455,0,4,0,5,7,0.714,0.455,1,2,0.5,0,2,2,3,3,0,6,1,11
2018,Raul Neto,PG,25,UTA,8,0,72,7,23,0.304,2,7,0.286,5,16,0.313,0.348,5,5,1,2,8,10,10,2,0,4,7,21
2018,Lucas Nogueira,C,25,TOR,5,0,24,0,1,0,0,0,0,0,1,0,0,1,2,0.5,0,1,1,1,0,0,3,6,1
2018,Jusuf Nurkic,C,23,POR,4,4,94,19,39,0.487,0,0,0,19,39,0.487,0.487,9,11,0.818,12,20,32,4,6,5,3,14,47
2018,Royce O'Neale,SF,24,UTA,11,5,259,28,56,0.5,10,28,0.357,18,28,0.643,0.589,12,19,0.632,3,35,38,15,10,4,16,30,78
2018,Semi Ojeleye,PF,23,BOS,17,3,230,10,33,0.303,6,22,0.273,4,11,0.364,0.394,6,7,0.857,4,24,28,2,3,0,2,21,32
2018,Emeka Okafor,C,35,NOP,1,0,4,0,1,0,0,0,0,0,1,0,0,0,0,0,0,0,0,0,0,0,0,1,0
2018,Victor Oladipo,SG,25,IND,7,7,261,53,127,0.417,23,57,0.404,30,70,0.429,0.508,30,41,0.732,3,55,58,42,17,3,24,11,159
2018,Kelly Olynyk,PF,26,MIA,5,0,146,21,44,0.477,8,19,0.421,13,25,0.52,0.568,14,20,0.7,7,16,23,19,7,6,8,19,64
2018,Chinanu Onuaku,C,21,HOU,1,0,3,0,0,,0,0,0,0,0,0,,0,0,0,1,0,1,1,1,0,0,1,0
2018,Cedi Osman,SF,22,CLE,14,0,62,6,18,0.333,1,7,0.143,5,11,0.455,0.361,1,4,0.25,1,6,7,3,3,0,0,5,14
2018,Kelly Oubre,SF,22,WAS,6,1,148,18,48,0.375,4,19,0.211,14,29,0.483,0.417,16,18,0.889,1,22,23,4,6,3,5,16,56
2018,Zaza Pachulia,C,33,GSW,7,0,26,4,7,0.571,0,0,0,4,7,0.571,0.571,9,12,0.75,6,6,12,1,3,1,3,1,17
2018,Jabari Parker,PF,22,MIL,7,0,167,28,62,0.452,6,19,0.316,22,43,0.512,0.5,8,13,0.615,8,35,43,10,7,4,6,15,70
2018,Tony Parker,PG,35,SAS,5,0,67,14,37,0.378,0,5,0,14,32,0.438,0.378,5,7,0.714,0,4,4,6,2,0,4,2,33
2018,Patrick Patterson,PF,28,OKC,6,0,58,3,6,0.5,2,4,0.5,1,2,0.5,0.667,0,0,0,1,10,11,3,1,0,3,8,8
2018,Brandon Paul,SG,26,SAS,1,0,3,0,0,,0,0,0,0,0,0,,0,0,0,0,1,1,1,0,0,0,0,0
2018,Chris Paul,PG,32,HOU,15,15,517,118,257,0.459,37,99,0.374,81,158,0.513,0.531,44,53,0.83,9,80,89,87,30,4,28,47,317
2018,Jakob Poeltl,C,22,TOR,9,0,140,17,31,0.548,0,1,0,17,30,0.567,0.548,15,19,0.789,15,21,36,6,3,4,8,25,49
2018,Otto Porter,SF,24,WAS,5,5,158,20,41,0.488,5,12,0.417,15,29,0.517,0.549,5,8,0.625,1,24,25,8,6,5,3,6,50
2018,Norman Powell,SG,24,TOR,6,0,40,4,14,0.286,1,7,0.143,3,7,0.429,0.321,3,4,0.75,0,2,2,2,0,0,1,4,12
2018,Zhou Qi,C,22,HOU,3,0,6,1,1,1,0,0,0,1,1,1,1,0,0,0,0,1,1,0,0,0,0,0,2
2018,J.J. Redick,SG,33,PHI,10,10,342,60,135,0.444,26,75,0.347,34,60,0.567,0.541,36,42,0.857,3,12,15,26,8,1,11,21,182
2018,Josh Richardson,SF,24,MIA,5,5,130,15,40,0.375,6,19,0.316,9,21,0.429,0.45,6,7,0.857,4,11,15,14,11,5,5,17,42
2018,Glenn Robinson,SF,24,IND,2,0,6,1,1,1,0,0,0,1,1,1,1,0,0,0,0,1,1,0,0,0,0,0,2
2018,Rajon Rondo,PG,31,NOP,9,9,302,38,92,0.413,8,19,0.421,30,73,0.411,0.457,9,14,0.643,9,59,68,110,13,2,33,20,93
2018,Derrick Rose,PG,29,MIN,5,0,119,29,57,0.509,7,10,0.7,22,47,0.468,0.57,6,7,0.857,1,8,9,13,2,0,8,9,71
2018,Terry Rozier,PG,23,BOS,19,19,696,108,266,0.406,51,147,0.347,57,119,0.479,0.502,46,56,0.821,8,92,100,109,24,6,22,38,313
2018,Ricky Rubio,PG,27,UTA,6,6,181,28,79,0.354,10,32,0.313,18,47,0.383,0.418,18,23,0.783,5,39,44,42,8,3,18,13,84
2018,Domantas Sabonis,C,21,IND,7,0,166,36,62,0.581,1,7,0.143,35,55,0.636,0.589,14,18,0.778,14,18,32,5,1,2,7,22,87
2018,Dario Saric,PF,23,PHI,10,10,329,59,140,0.421,20,52,0.385,39,88,0.443,0.493,34,40,0.85,32,41,73,35,10,4,15,28,172
2018,Tomas Satoransky,SG,26,WAS,6,0,60,2,13,0.154,0,3,0,2,10,0.2,0.154,3,4,0.75,5,4,9,3,0,0,3,4,7
2018,Mike Scott,PF,29,WAS,6,0,126,26,41,0.634,7,11,0.636,19,30,0.633,0.72,6,6,1,6,15,21,4,2,1,5,10,65
2018,Pascal Siakam,PF,23,TOR,10,0,179,25,41,0.61,3,4,0.75,22,37,0.595,0.646,13,20,0.65,9,27,36,8,1,6,7,27,66
2018,Ben Simmons,PG,21,PHI,10,10,369,61,125,0.488,0,1,0,61,124,0.492,0.488,41,58,0.707,16,78,94,77,17,8,44,34,163
2018,Marcus Smart,SG,23,BOS,15,4,449,48,143,0.336,15,68,0.221,33,75,0.44,0.388,36,49,0.735,14,42,56,80,26,10,36,44,147
2018,J.R. Smith,SG,32,CLE,22,21,706,65,187,0.348,44,120,0.367,21,67,0.313,0.465,17,22,0.773,10,50,60,25,21,4,19,54,191
2018,Jason Smith,C,31,WAS,1,0,2,0,0,,0,0,0,0,0,0,,0,0,0,0,0,0,0,0,0,0,0,0
2018,Tony Snell,SG,26,MIL,7,2,134,7,24,0.292,5,21,0.238,2,3,0.667,0.396,0,0,0,1,12,13,4,3,4,3,10,19
2018,Lance Stephenson,SG,27,IND,7,0,149,30,65,0.462,8,26,0.308,22,39,0.564,0.523,5,9,0.556,3,16,19,20,2,1,9,20,73
2018,David Stockton,PG,26,UTA,2,0,6,1,3,0.333,0,1,0,1,2,0.5,0.333,0,0,0,0,1,1,0,0,0,0,1,2
2018,Caleb Swanigan,PF,20,POR,1,0,8,0,2,0,0,1,0,0,1,0,0,3,4,0.75,0,2,2,1,0,0,1,1,3
2018,Jayson Tatum,SF,19,BOS,19,19,683,123,261,0.471,23,71,0.324,100,190,0.526,0.515,82,97,0.845,10,73,83,52,23,10,41,50,351
2018,Jeff Teague,PG,29,MIN,5,5,153,23,51,0.451,7,18,0.389,16,33,0.485,0.52,12,17,0.706,3,15,18,29,3,2,14,19,65
2018,Jason Terry,SG,40,MIL,3,0,44,2,5,0.4,2,5,0.4,0,0,0,0.6,0,0,0,1,1,2,2,1,0,1,2,6
2018,Klay Thompson,SG,27,GSW,21,21,794,159,342,0.465,67,157,0.427,92,185,0.497,0.563,27,31,0.871,11,75,86,38,16,6,31,48,412
2018,Tristan Thompson,C,26,CLE,19,11,416,49,83,0.59,0,1,0,49,82,0.598,0.59,20,27,0.741,44,68,112,11,2,8,11,26,118
2018,Karl-Anthony Towns,C,22,MIN,5,5,170,28,60,0.467,3,11,0.273,25,49,0.51,0.492,17,23,0.739,15,52,67,11,2,5,12,14,76
2018,P.J. Tucker,PF,32,HOU,17,17,569,52,108,0.481,35,75,0.467,17,33,0.515,0.644,12,18,0.667,23,88,111,22,11,13,14,46,151
2018,Evan Turner,SF,29,POR,3,3,87,12,33,0.364,2,7,0.286,10,26,0.385,0.394,2,2,1,5,7,12,10,3,1,6,8,28
2018,Myles Turner,C,21,IND,7,7,196,33,54,0.611,6,13,0.462,27,41,0.659,0.667,15,19,0.789,6,30,36,4,2,4,11,25,87
2018,Ekpe Udoh,C,30,UTA,6,0,21,1,1,1,0,0,0,1,1,1,1,0,4,0,1,2,3,0,0,2,1,2,2
2018,Jonas Valanciunas,C,25,TOR,10,9,244,58,107,0.542,2,5,0.4,56,102,0.549,0.551,28,34,0.824,30,75,105,12,4,15,19,22,146
2018,Fred VanVleet,PG,23,TOR,6,1,114,13,39,0.333,8,28,0.286,5,11,0.455,0.436,7,8,0.875,0,10,10,13,0,0,4,8,41
2018,Dwyane Wade,SG,36,MIA,5,0,127,31,70,0.443,0,4,0,31,66,0.47,0.443,21,26,0.808,3,18,21,18,7,1,11,11,83
2018,John Wall,PG,27,WAS,6,6,234,56,127,0.441,4,21,0.19,52,106,0.491,0.457,40,47,0.851,3,31,34,69,14,8,27,16,156
2018,David West,C,37,GSW,18,0,175,27,45,0.6,1,2,0.5,26,43,0.605,0.611,4,4,1,11,26,37,32,6,10,10,23,59
2018,Russell Westbrook,PG,29,OKC,6,6,235,64,161,0.398,15,42,0.357,49,119,0.412,0.444,33,40,0.825,11,61,72,45,9,0,31,21,176
2018,Derrick White,PG,23,SAS,3,0,18,3,6,0.5,1,2,0.5,2,4,0.5,0.583,0,0,0,0,0,0,1,1,2,0,0,7
2018,Hassan Whiteside,C,28,MIA,5,5,77,9,20,0.45,0,0,0,9,20,0.45,0.45,8,13,0.615,10,20,30,1,0,6,12,16,26
2018,Andrew Wiggins,SF,22,MIN,5,5,164,30,68,0.441,7,21,0.333,23,47,0.489,0.493,12,20,0.6,5,21,26,10,2,2,9,14,79
2018,Justise Winslow,PF,21,MIA,5,0,125,15,42,0.357,7,19,0.368,8,23,0.348,0.44,12,17,0.706,7,26,33,13,4,4,8,17,49
2018,Delon Wright,PG,25,TOR,10,0,215,31,68,0.456,9,21,0.429,22,47,0.468,0.522,15,16,0.938,3,19,22,23,15,9,9,10,86
2018,Guerschon Yabusele,PF,22,BOS,12,0,48,1,9,0.111,0,6,0,1,3,0.333,0.111,2,5,0.4,3,8,11,3,2,0,0,9,4
2018,Joe Young,PG,25,IND,1,0,3,0,0,,0,0,0,0,0,0,,0,0,0,0,0,0,0,0,0,0,1,0
2018,Nick Young,SG,32,GSW,20,2,205,16,53,0.302,14,47,0.298,2,6,0.333,0.434,6,8,0.75,1,11,12,4,1,0,2,18,52
2018,Thaddeus Young,PF,29,IND,7,7,237,36,60,0.6,2,7,0.286,34,53,0.642,0.617,5,13,0.385,22,32,54,10,12,6,7,22,79
2018,Tyler Zeller,C,28,MIL,7,3,66,4,5,0.8,0,0,0,4,5,0.8,0.8,3,4,0.75,2,12,14,3,4,3,1,11,11
2018,Ante Zizic,C,21,CLE,8,0,23,5,10,0.5,0,0,0,5,10,0.5,0.5,3,6,0.5,1,5,6,1,0,1,2,2,13
